acmana_c	GSC
glyald_c	GSC
fpram_c	GSC
udpgal_c	GSC
dohdu_c	GSC
dmh2mpt_c	GSC
23dpg_c	GSC
pmcoa_c	GSC
dma_e	GSC
h3acon_C_c	GSC
orot_c	GSC
mal__L_c	GSC
h2acon_C_c	GSC
gmp_c	GSC
dscl_c	GSC
hacon_T_c	GSC
fprica_c	GSC
ala__L_c	GSC
xu5p__D_c	GSC
fgam_c	GSC
dkmp_c	GSC
fc1p_c	GSC
ac_e	GSC
dhnpt_c	GSC
aicar_c	GSC
lppg_c	GSC
f420_2h2_c	GSC
r5p_c	GSC
3php_c	GSC
adn_c	GSC
ihcit_T_c	GSC
tih3cit_c	GSC
dhap_c	GSC
cbasp_c	GSC
s7p_c	GSC
cbp_c	GSC
hphaccoa_c	GSC
f420_1_c	GSC
5aprbu_c	GSC
dmpp_c	GSC
dhadrp_c	GSC
copre5_c	GSC
cit_c	GSC
Shcit_c	GSC
2dr1p_c	GSC
f6p_c	GSC
aspsa_c	GSC
oaa_c	GSC
25dhpp_c	GSC
menylh4spt_c	GSC
gdp_c	GSC
7mhp_c	GSC
acser_c	GSC
arg__L_c	GSC
5oxpro_c	GSC
chor_c	GSC
hom__L_c	GSC
met__L_c	GSC
akg_c	GSC
dggpi_c	GSC
db4p_c	GSC
gggp_c	GSC
glu__L_c	GSC
inost_c	GSC
etoh_c	GSC
gam6p_c	GSC
argsuc_c	GSC
prfp_c	GSC
uacmam_c	GSC
sl__L_c	GSC
g3p_c	GSC
dohau_c	GSC
gly_c	GSC
prbamp_c	GSC
glycogen_c	GSC
hcys__L_c	GSC
6hmhptpp_c	GSC
ser__L_c	GSC
prbatp_c	GSC
sec_c	GSC
ppbng_c	GSC
mi1p__D_c	GSC
cob_c	GSC
mphenh2_c	GSC
dhadrdpr_c	GSC
orot5p_c	GSC
accoa_c	GSC
f1p_c	GSC
hsfd_c	GSC
pran_c	GSC
skm5p_c	GSC
fdp_c	GSC
imp_c	GSC
3spyr_c	GSC
3psme_c	GSC
dhor__S_c	GSC
phom_c	GSC
gln__L_c	GSC
Rh2cit_c	GSC
Brfap_c	GSC
glu__L_e	GSC
dgggp_c	GSC
cdpg_c	GSC
mma_e	GSC
mfr_b_c	GSC
copre3_c	GSC
g1p_c	GSC
btn_c	GSC
Rh3cit_c	GSC
2saa_c	GSC
7mht_c	GSC
copre4_c	GSC
4kfbp_c	GSC
man1p_c	GSC
glutrna_c	GSC
gly_e	GSC
citr__L_c	GSC
3pg_c	GSC
achms_c	GSC
ac_c	GSC
asn__L_c	GSC
rb15bp_c	GSC
fum_c	GSC
f420_0_c	GSC
ohexa_c	GSC
f390g_c	GSC
e4p_c	GSC
h2mpt_c	GSC
uppg3_c	GSC
acg5sa_c	GSC
7ohp_c	GSC
man6p_c	GSC
dmlz_c	GSC
nicrnt_c	GSC
slp__L_c	GSC
skm_c	GSC
gar_c	GSC
h4mpt_c	GSC
dhadr_c	GSC
2ood_c	GSC
uacgam_c	GSC
5hbzid_c	GSC
5aizc_c	GSC
com_c	GSC
gal1p_c	GSC
4r5au_c	GSC
13dpg_c	GSC
tyr__L_c	GSC
gtp_c	GSC
cys__L_c	GSC
mcom_c	GSC
mma_c	GSC
2plac__L_c	GSC
6hmhpt_c	GSC
glyc1p_c	GSC
actp_c	GSC
8aonn_c	GSC
dcamp_c	GSC
hmbil_c	GSC
quln_c	GSC
3ig3p_c	GSC
acgam1p_c	GSC
acg5p_c	GSC
mphen_c	GSC
ahcys_c	GSC
pep_c	GSC
hacon_C_c	GSC
xmp_c	GSC
glu1sa_c	GSC
prlp_c	GSC
dhrfap_c	GSC
glyald_e	GSC
thr__L_c	GSC
udpg_c	GSC
dkfp_c	GSC
25aics_c	GSC
ptp_c	GSC
2cpr5p_c	GSC
air_c	GSC
S2hglut_c	GSC
thymd_c	GSC
h4spt_c	GSC
gdpmann_c	GSC
mleneh4spt_c	GSC
ura_c	GSC
cys__L_e	GSC
acald_c	GSC
dann_c	GSC
3dhsk_c	GSC
34hpp_c	GSC
pser__L_c	GSC
pyr_c	GSC
5aop_c	GSC
thym_c	GSC
acorn_c	GSC
5caiz_c	GSC
icit_c	GSC
dkdofp_c	GSC
lac__L_c	GSC
formmfr_b_c	GSC
duri_c	GSC
amet_c	GSC
tih2cit_c	GSC
f420_2_c	GSC
dpgpi_c	GSC
lald__L_c	GSC
dhadrpr_c	GSC
mh4spt_c	GSC
frdp_c	GSC
ala__L_e	GSC
gam1p_c	GSC
f390a_c	GSC
psd5p_c	GSC
pram_c	GSC
25dthpp_c	GSC
udpglcur_c	GSC
dhp23cp_c	GSC
ribflv_c	GSC
glc__D_c	GSC
agdpgpi_c	GSC
amob_c	GSC
g6p_c	GSC
nac_c	GSC
orn_c	GSC
pphn_c	GSC
asp__L_c	GSC
mmh2mpt_c	GSC
ru5p__D_c	GSC
succoa_c	GSC
dma_c	GSC
anth_c	GSC
cdgggp_c	GSC
ohepa_c	GSC
dhpmp_c	GSC
prpp_c	GSC
dtbt_c	GSC
3dhq_c	GSC
dhadrtpr_c	GSC
formh4spt_c	GSC
acglu_c	GSC
grdp_c	GSC
2tcc_c	GSC
ddhrb_c	GSC
copre2_c	GSC
ggdp_c	GSC
r15bp_c	GSC
2pg_c	GSC
dxyl5p_c	IN
dms_c	IN
fru_c	IN
ribflv_e	IN
ahdt_c	IN
hmgcoa_c	IN
rib__D_c	IN
nac_e	IN
iasp_c	IN
5pmev_c	IN
dms_e	IN
ipdp_c	IN
pyr_e	IN
tma_e	IN
mev__R_c	IN
csn_c	IN
xan_c	IN
5mta_c	IN
4hphac_c	IN
hxan_c	IN
4abz_c	IN
meoh_e	IN
4abz_e	IN
btn_e	IN
5dpmev_c	IN
fmn_c	IN
tma_c	IN
4hphac_e	IN
gua_c	IN
meoh_c	IN
ade_c	IN
cit_e	IN
val__L_e	OUT
dggpgp_c	OUT
indole_c	OUT
dpgpe_c	OUT
hista_c	OUT
pro__L_c	OUT
23dhmb_c	OUT
phpyr_c	OUT
applp_c	OUT
pant__R_c	OUT
histd_c	OUT
3hcdgggp_c	OUT
urea_c	OUT
sf430a_c	OUT
argtrna_c	OUT
2mahmp_c	OUT
glntrna_c	OUT
f430p1_c	OUT
sheme_c	OUT
alac__S_c	OUT
valtrna_c	OUT
carn_c	OUT
1pyr5c_c	OUT
dcmp_c	OUT
amp_c	OUT
phetrna_c	OUT
thm_c	OUT
pan4p_c	OUT
f430p2_c	OUT
glu5sa_c	OUT
thrtrna_c	OUT
26dap__M_c	OUT
4pasp_c	OUT
gdpddman_c	OUT
nad_c	OUT
unknown_rbfdeg_e	OUT
adocblhbi_c	OUT
thmmp_c	OUT
gdpofuc_c	OUT
imacp_c	OUT
dctp_c	OUT
4abut_c	OUT
scl_c	OUT
datp_c	OUT
eig3p_c	OUT
agm_c	OUT
fmettrna_c	OUT
thmpp_c	OUT
codhpre6_c	OUT
co2dam_c	OUT
hspmd_c	OUT
nabl_c	OUT
dgtp_c	OUT
udp_c	OUT
aacoa_c	OUT
asptrna_c	OUT
glyc__R_c	OUT
gcald_c	OUT
dtdp_c	OUT
dpcoa_c	OUT
ptrc_c	OUT
damp_c	OUT
4ampm_c	OUT
dttp_c	OUT
leutrna_c	OUT
utp_c	OUT
f430_c	OUT
agdpcbi_c	OUT
6pgl_c	OUT
cobya_c	OUT
sucsal_c	OUT
dtdp4d6dm_c	OUT
adcobdam_c	OUT
2ins_c	OUT
dggpg_c	OUT
indpyr_c	OUT
hisp_c	OUT
3hdpgps_c	OUT
dtdprmn_c	OUT
trp__L_c	OUT
dhf_c	OUT
alatrna_c	OUT
3hdpgpi_c	OUT
ch4_c	OUT
copre8_c	OUT
2ippm_c	OUT
histrna_c	OUT
dnad_c	OUT
trptrna_c	OUT
3mop_c	OUT
4ppan_c	OUT
3hdggpg_c	OUT
3c3hmp_c	OUT
4hba_c	OUT
for_c	OUT
ctp_c	OUT
gdpfuc_c	OUT
4ahmmp_c	OUT
ch4s_c	OUT
uaccg_c	OUT
his__L_c	OUT
3hdgggps_c	OUT
f420_7_c	OUT
gdpgpi_c	OUT
unknown_rbfdeg_c	OUT
thdp_c	OUT
ala_B_c	OUT
dpgpg_c	OUT
3hdggpi_c	OUT
3c2hmp_c	OUT
phe__L_c	OUT
2ahbut_c	OUT
f420_3_c	OUT
glutrna_gln_c	OUT
dudp_c	OUT
3mob_c	OUT
mettrna_c	OUT
cystrna_c	OUT
ppa_c	OUT
btamp_c	OUT
pnto__R_e	OUT
alac__S_e	OUT
36dahx_c	OUT
succ_c	OUT
ch4_e	OUT
val__L_c	OUT
23dhdp_c	OUT
ump_c	OUT
dtmp_c	OUT
urea_e	OUT
5pr5hbz_c	OUT
ch4s_e	OUT
leu__L_e	OUT
f420_5_c	OUT
ile__L_e	OUT
2dhp_c	OUT
actn__R_c	OUT
hcit_c	OUT
coa_c	OUT
ppcoa_c	OUT
f420_6_c	OUT
co1dam_c	OUT
dhpt_c	OUT
cmp_c	OUT
gcald_e	OUT
phaccoa_c	OUT
dcdp_c	OUT
adocbip_c	OUT
dha_c	OUT
nadp_c	OUT
3c4mop_c	OUT
3hdgggp_c	OUT
cdp_c	OUT
lystrna_c	OUT
sertrna_c	OUT
dadp_c	OUT
2obut_c	OUT
23dhmp_c	OUT
copre6_c	OUT
dgggps_c	OUT
uamr_c	OUT
adcobhex_c	OUT
thf_c	OUT
3hdpgpg_c	OUT
protrna_c	OUT
ile__L_c	OUT
ibcoa_c	OUT
glu5p_c	OUT
dutp_c	OUT
3hdpgpe_c	OUT
4ppcys_c	OUT
thrp_c	OUT
dump_c	OUT
tyrtrna_c	OUT
iletrna_c	OUT
ppap_c	OUT
r5hbzi_c	OUT
f430p3_c	OUT
lys__L_e	OUT
indaccoa_c	OUT
dpgps_c	OUT
dtdpglu_c	OUT
4mop_c	OUT
3hdggpgp_c	OUT
f420_4_c	OUT
dgdp_c	OUT
leu__L_c	OUT
oxa_c	OUT
glytrna_c	OUT
dtdp4d6dg_c	OUT
adp_c	OUT
pnto__R_c	OUT
lys__L_c	OUT
actn__R_e	OUT
4mpetz_c	OUT
pro__L_e	IS
gthrd_c	IS
nmn_c	IS
mlthf_c	IS
pap_c	IS
cbl1_e	IS
atrz_c	IS
3hgrdp_c	IS
aconm_c	IS
glyclt_c	IS
ind3ac_e	IS
5mthf_c	IS
pac_e	IS
acetone_c	IS
ppp9_c	IS
56dura_c	IS
2ppoh_c	IS
glcn_c	IS
5odhf2a_c	IS
etha_c	IS
3hfrdp_c	IS
glyb_e	IS
unknown_cbl1deg_e	IS
adocbi_c	IS
hgbam_c	IS
glyb_c	IS
unknown_cbl1deg_c	IS
acon_T_c	IS
thm_e	IS
fald_c	IS
10fthf_c	IS
6ax_c	IS
mppp9_c	IS
glyc_e	IS
itp_c	IS
4mhetz_c	IS
6ax6ax_c	IS
cala_c	IS
3uib_c	IS
m3hdp_c	IS
appl_c	IS
2pglyc_c	IS
fol_c	IS
gthox_c	IS
idp_c	IS
cbi_e	IS
cbl1hbi_e	IS
caphis_c	IS
cbi_c	IS
cbl1_c	IS
56dthm_c	IS
4cml_c	IS
3hggdp_c	IS
co_c	IS
5mdr1p_c	IS
co_e	IS
fol_e	IS
atp_c	IS
ind3ac_c	IS
camp_c	IS
cmaphis_c	IS
pac_c	IS
etha_e	IS
6pthp_c	IS
hatrz_c	IS
cbl1hbi_c	IS
methf_c	IS
paps_c	IS
glcn_e	IS
glyc_c	IS
