gsn_c	GSC
ru5p__L_c	GSC
fpram_c	GSC
pgp161_c	GSC
glu__D_c	GSC
udpgal_c	GSC
3opalmACP_c	GSC
forglu_c	GSC
clpn120_c	GSC
acmana_c	GSC
pg161_c	GSC
orot_c	GSC
mal__L_c	GSC
pg181_c	GSC
histd_c	GSC
ametam_c	GSC
cdpdddecg_c	GSC
tdeACP_c	GSC
dscl_c	GSC
ala__L_c	GSC
xu5p__D_c	GSC
fgam_c	GSC
pgp140_c	GSC
murein5p5p5p_e	GSC
ac_e	GSC
2dda7p_c	GSC
cyst__L_c	GSC
malcoa_c	GSC
etoh_e	GSC
r5p_c	GSC
suchms_c	GSC
3php_c	GSC
3ooctACP_c	GSC
3odecACP_c	GSC
adn_c	GSC
glyc_e	GSC
dhap_c	GSC
2mecdp_c	GSC
butACP_c	GSC
cbasp_c	GSC
s7p_c	GSC
pa160_c	GSC
cbp_c	GSC
5mta_c	GSC
pg180_c	GSC
met__L_e	GSC
dmpp_c	GSC
citr__L_e	GSC
pa180_c	GSC
pa181_c	GSC
copre5_c	GSC
26dap__M_c	GSC
4pasp_c	GSC
cit_c	GSC
2dr1p_c	GSC
ins_c	GSC
3ocddec5eACP_c	GSC
f6p_c	GSC
pa120_c	GSC
imacp_c	GSC
4abut_c	GSC
aspsa_c	GSC
oaa_c	GSC
urcan_c	GSC
3hddecACP_c	GSC
eig3p_c	GSC
cdpdodec11eg_c	GSC
acser_c	GSC
cdpdhdec9eg_c	GSC
arg__L_c	GSC
chor_c	GSC
2dr5p_c	GSC
met__L_c	GSC
akg_c	GSC
hom__L_c	GSC
asp__D_c	GSC
murein5p4p_e	GSC
etoh_c	GSC
glu__L_c	GSC
ser__L_e	GSC
glyc_c	GSC
ocdcaACP_c	GSC
1odec11eg3p_c	GSC
gam6p_c	GSC
2p4c2me_c	GSC
argsuc_c	GSC
thex2eACP_c	GSC
4c2me_c	GSC
prfp_c	GSC
sl26da_c	GSC
cdec3eACP_c	GSC
uacmam_c	GSC
g3p_c	GSC
alaala_c	GSC
clpn161_c	GSC
clpn160_c	GSC
gly_c	GSC
prbamp_c	GSC
lac__D_c	GSC
hcys__L_c	GSC
3hdecACP_c	GSC
ser__L_c	GSC
prbatp_c	GSC
ptrc_c	GSC
ppbng_c	GSC
ipdp_c	GSC
orot5p_c	GSC
accoa_c	GSC
glyc3p_c	GSC
tdec2eACP_c	GSC
pran_c	GSC
skm5p_c	GSC
myrsACP_c	GSC
3hoctACP_c	GSC
fdp_c	GSC
octeACP_c	GSC
s17bp_c	GSC
tpalm2eACP_c	GSC
sucsal_c	GSC
xan_c	GSC
hisp_c	GSC
3psme_c	GSC
dhor__S_c	GSC
phom_c	GSC
udcpp_c	GSC
dhf_c	GSC
gln__L_c	GSC
udcpdp_c	GSC
pg120_c	GSC
copre3_c	GSC
g1p_c	GSC
4abutn_c	GSC
r1p_c	GSC
copre4_c	GSC
glutrna_c	GSC
3ocpalm9eACP_c	GSC
3hoctaACP_c	GSC
citr__L_c	GSC
gua_c	GSC
3pg_c	GSC
achms_c	GSC
t3c9palmeACP_c	GSC
uamag_c	GSC
ac_c	GSC
fum_c	GSC
uaccg_c	GSC
his__L_c	GSC
3hcddec5eACP_c	GSC
e4p_c	GSC
h2mb4p_c	GSC
uppg3_c	GSC
acg5sa_c	GSC
man6p_c	GSC
skm_c	GSC
gar_c	GSC
thdp_c	GSC
toct2eACP_c	GSC
uacgam_c	GSC
56dura_c	GSC
5aizc_c	GSC
acon_C_c	GSC
cdpdodecg_c	GSC
but2eACP_c	GSC
hdeACP_c	GSC
t3c5ddeceACP_c	GSC
1tdecg3p_c	GSC
13dpg_c	GSC
1ddecg3p_c	GSC
3haACP_c	GSC
cys__L_c	GSC
3ohexACP_c	GSC
palmACP_c	GSC
pg140_c	GSC
ocACP_c	GSC
2me4p_c	GSC
ala__D_e	GSC
actp_c	GSC
dcamp_c	GSC
malACP_c	GSC
hmbil_c	GSC
hexACP_c	GSC
cddec5eACP_c	GSC
succ_c	GSC
3ig3p_c	GSC
uaagmda_c	GSC
23dhdp_c	GSC
acg5p_c	GSC
acgam1p_c	GSC
tddec2eACP_c	GSC
4abz_c	GSC
pep_c	GSC
1hdec9eg3p_c	GSC
xtsn_c	GSC
3hcvac11eACP_c	GSC
3hmrsACP_c	GSC
glu1sa_c	GSC
prlp_c	GSC
clpn181_c	GSC
glx_c	GSC
din_c	GSC
thr__L_c	GSC
udpg_c	GSC
cdpdhdecg_c	GSC
4adcho_c	GSC
25aics_c	GSC
2cpr5p_c	GSC
acACP_c	GSC
air_c	GSC
3hcmrs7eACP_c	GSC
sl2a6o_c	GSC
26dap_LL_c	GSC
3hhexACP_c	GSC
ura_c	GSC
udcpdp_e	GSC
murein5p5p_e	GSC
ade_c	GSC
acald_c	GSC
clpn140_c	GSC
3dhsk_c	GSC
dhpt_c	GSC
udcpp_e	GSC
dxyl5p_c	GSC
uama_c	GSC
4h2oglt_c	GSC
cdpdtdecg_c	GSC
uaagmda_e	GSC
murein5px4px4p_e	GSC
pa140_c	GSC
pgp160_c	GSC
dha_c	GSC
dad_2_c	GSC
pser__L_c	GSC
pyr_c	GSC
5aop_c	GSC
toctd2eACP_c	GSC
dcaACP_c	GSC
pgp180_c	GSC
icit_c	GSC
pa161_c	GSC
acorn_c	GSC
thfglu_c	GSC
3hpalmACP_c	GSC
his__L_e	GSC
duri_c	GSC
amet_c	GSC
uamr_c	GSC
lald__L_c	GSC
thf_c	GSC
frdp_c	GSC
4izp_c	GSC
gam1p_c	GSC
ugmd_c	GSC
pyr_e	GSC
3oddecACP_c	GSC
pram_c	GSC
ncam_c	GSC
3omrsACP_c	GSC
3ooctdACP_c	GSC
pgp120_c	GSC
g6p_c	GSC
orn_c	GSC
3hcpalm9eACP_c	GSC
hxan_c	GSC
arg__L_e	GSC
12ppd__S_c	GSC
ru5p__D_c	GSC
asp__L_c	GSC
murein5px4p_e	GSC
3ocmrs7eACP_c	GSC
3ocvac11eACP_c	GSC
1hdecg3p_c	GSC
pgp181_c	GSC
1odecg3p_c	GSC
lac__D_e	GSC
t3c7mrseACP_c	GSC
uagmda_c	GSC
ala__D_c	GSC
anth_c	GSC
t3c11vaceACP_c	GSC
dgsn_c	GSC
tmrs2eACP_c	GSC
prpp_c	GSC
3dhq_c	GSC
rml1p_c	GSC
clpn180_c	GSC
grdp_c	GSC
pg160_c	GSC
acglu_c	GSC
rnam_c	GSC
ugmda_c	GSC
ddcaACP_c	GSC
copre2_c	GSC
actACP_c	GSC
2pg_c	GSC
rmn_c	IN
2ddg6p_c	IN
adprib_c	IN
12dgr160_c	IN
g3pg_c	IN
g3pe_c	IN
12dgr120_c	IN
12dgr140_c	IN
xyl__D_e	IN
fru_c	IN
xyl__D_c	IN
rbl__L_c	IN
rib__D_c	IN
glyc__R_c	IN
glcn_c	IN
cfesp_c	IN
6hmhptpp_c	IN
araban__L_e	IN
dhnpt_c	IN
g3pc_c	IN
murein5p3p_e	IN
f1p_c	IN
2h3oppan_c	IN
12dgr161_c	IN
csn_c	IN
asp__L_e	IN
rml_c	IN
rhcys_c	IN
glc__D_c	IN
ptrc_e	IN
rib__D_e	IN
fru_e	IN
fol_c	IN
dcyt_c	IN
ahcys_c	IN
glu__L_e	IN
12dgr180_c	IN
man_e	IN
xylu__D_c	IN
gln__L_e	IN
succoa_c	IN
acmama_c	IN
glc__D_e	IN
mecfsp_c	IN
csn_e	IN
fol_e	IN
arab__L_c	IN
2ahhmp_c	IN
gly_e	IN
12dgr181_c	IN
6pgc_c	IN
ura_e	IN
xan_e	IN
arab__L_e	IN
cys__L_e	IN
Nforglu_c	IN
glcn_e	IN
3sala_c	IN
rmn_e	IN
indole_c	OUT
val__L_e	OUT
b2coa_c	OUT
pro__L_c	OUT
23dhmb_c	OUT
mlthf_c	OUT
phpyr_c	OUT
applp_c	OUT
pant__R_c	OUT
uri_c	OUT
mql8_c	OUT
gmp_c	OUT
aps_c	OUT
pe181_c	OUT
urea_c	OUT
fprica_c	OUT
iasp_c	OUT
aicar_c	OUT
rdmbzi_c	OUT
sheme_c	OUT
frmd_c	OUT
alac__S_c	OUT
valtrna_c	OUT
1pyr5c_c	OUT
dcmp_c	OUT
alpro_c	OUT
amp_c	OUT
phetrna_c	OUT
pre3a_c	OUT
pan4p_c	OUT
ps180_c	OUT
glu5sa_c	OUT
5aprbu_c	OUT
pe161_c	OUT
nad_c	OUT
dctp_c	OUT
scl_c	OUT
datp_c	OUT
25dhpp_c	OUT
gdp_c	OUT
agm_c	OUT
ps120_c	OUT
db4p_c	OUT
codhpre6_c	OUT
3hbcoa_c	OUT
2dmmql8_c	OUT
co2dam_c	OUT
dgtp_c	OUT
pap_c	OUT
udp_c	OUT
ahdt_c	OUT
5mthf_c	OUT
aacoa_c	OUT
dtdp_c	OUT
dpcoa_c	OUT
asn__L_e	OUT
damp_c	OUT
dttp_c	OUT
5apru_c	OUT
leutrna_c	OUT
utp_c	OUT
ps161_c	OUT
agdpcbi_c	OUT
imp_c	OUT
mthgxl_c	OUT
cobya_c	OUT
dgmp_c	OUT
dtdp4d6dm_c	OUT
adcobdam_c	OUT
urate_c	OUT
dtdprmn_c	OUT
trp__L_c	OUT
copre8_c	OUT
2ippm_c	OUT
cbi_c	OUT
5prdmbz_c	OUT
dnad_c	OUT
ps160_c	OUT
3mop_c	OUT
4ppan_c	OUT
pe140_c	OUT
3c3hmp_c	OUT
for_c	OUT
ctp_c	OUT
gdptp_c	OUT
methf_c	OUT
asn__L_c	OUT
btcoa_c	OUT
btd_RR_c	OUT
dmlz_c	OUT
nicrnt_c	OUT
btd_RR_e	OUT
5hbzid_c	OUT
ala_B_c	OUT
octdp_c	OUT
3c2hmp_c	OUT
2ahbut_c	OUT
phe__L_c	OUT
adocbl_c	OUT
adocbi_c	OUT
tyr__L_c	OUT
dudp_c	OUT
gtp_c	OUT
3mob_c	OUT
teca_CL_c	OUT
mettrna_c	OUT
ppa_c	OUT
udpgalfur_c	OUT
quln_c	OUT
alaala_e	OUT
val__L_c	OUT
murein4px4p_e	OUT
ump_c	OUT
dtmp_c	OUT
xmp_c	OUT
leu__L_e	OUT
cbl1_c	OUT
pe180_c	OUT
ile__L_e	OUT
2dhp_c	OUT
actn__R_c	OUT
hcit_c	OUT
coa_c	OUT
ppcoa_c	OUT
co1dam_c	OUT
butpi_c	OUT
cmp_c	OUT
15dap_c	OUT
pe160_c	OUT
dcdp_c	OUT
adocbip_c	OUT
cdpglyc_c	OUT
34hpp_c	OUT
nadp_c	OUT
3c4mop_c	OUT
cdp_c	OUT
murein4p4p_e	OUT
sertrna_c	OUT
dadp_c	OUT
2obut_c	OUT
23dhmp_c	OUT
dmbzid_c	OUT
copre6_c	OUT
adcobhex_c	OUT
ps181_c	OUT
ile__L_c	OUT
ps140_c	OUT
glu5p_c	OUT
dutp_c	OUT
10fthf_c	OUT
btal_c	OUT
udpglcur_c	OUT
thrp_c	OUT
4ppcys_c	OUT
dump_c	OUT
cytd_c	OUT
iletrna_c	OUT
nac_c	OUT
ppap_c	OUT
lys__L_e	OUT
pe120_c	OUT
pphn_c	OUT
spmd_c	OUT
4mop_c	OUT
dtdpglu_c	OUT
trp__L_e	OUT
pydx5p_c	OUT
dgdp_c	OUT
leu__L_c	OUT
murein5px3p_e	OUT
dtdp4d6dg_c	OUT
adp_c	OUT
pnto__R_c	OUT
lys__L_c	OUT
murein4px4px4p_e	OUT
5mtr_c	OUT
ggdp_c	OUT
phthr_c	IS
hgbyr_c	IS
murein4p3p_e	IS
galur_c	IS
mththf_c	IS
etha_c	IS
2mahmp_c	IS
acmam_c	IS
thm_e	IS
thm_c	IS
pdx5p_c	IS
pre5_c	IS
ditp_c	IS
btn_e	IS
malt_e	IS
thmmp_c	IS
atp_c	IS
dhptd_c	IS
malthx_e	IS
thmpp_c	IS
hdca_c	IS
pro__L_e	IS
ribflv_e	IS
dad_5_c	IS
abt_c	IS
glcur_c	IS
but_e	IS
4hthr_c	IS
gcald_c	IS
dimp_c	IS
tag6p__D_c	IS
4ampm_c	IS
alltt_c	IS
cpppg3_c	IS
taur_e	IS
malthx_c	IS
appl_c	IS
btn_c	IS
man1p_c	IS
dhna_c	IS
gal_c	IS
pre6a_c	IS
4ahmmp_c	IS
pre6b_c	IS
fad_c	IS
stcoa_c	IS
mdhdhf_c	IS
glyb_e	IS
mqn8_c	IS
4r5au_c	IS
gal_e	IS
ocdca_c	IS
btamp_c	IS
itp_c	IS
for_e	IS
4mhetz_c	IS
pppg9_c	IS
ser__D_e	IS
5dh4dglc_c	IS
btoh_c	IS
malttr_e	IS
pre8_c	IS
co_e	IS
gdpmann_c	IS
pre4_c	IS
btoh_e	IS
tagdp__D_c	IS
pydxn_c	IS
co_c	IS
malttr_c	IS
alltn_e	IS
galct__D_c	IS
ser__D_c	IS
glcur_e	IS
ttdca_c	IS
2ahhmd_c	IS
glyb_c	IS
galur_e	IS
malt_c	IS
pydxn_e	IS
pmtcoa_c	IS
galctn__D_c	IS
ribflv_c	IS
pre3b_c	IS
tdcoa_c	IS
alltn_c	IS
spmd_e	IS
fmn_c	IS
glcr_c	IS
taur_c	IS
chol_c	IS
but_c	IS
galctn__D_e	IS
4mpetz_c	IS
