gsn_c	GSC
ru5p__L_c	GSC
pgp161_c	GSC
hhlipa_c	GSC
3opalmACP_c	GSC
pro__L_c	GSC
pgp140_p	GSC
seramp_c	GSC
cgly_e	GSC
fru_c	GSC
kdo2lipid4L_c	GSC
gsn_e	GSC
mal__L_c	GSC
hxa_e	GSC
gmp_c	GSC
mal__L_e	GSC
pe181_c	GSC
iasp_c	GSC
suchms_c	GSC
succ_p	GSC
adn_c	GSC
1pyr5c_c	GSC
3ohcoa_c	GSC
3odecACP_c	GSC
cbasp_c	GSC
cbp_c	GSC
2agpe181_c	GSC
rhmn_c	GSC
3hocoa_c	GSC
anhgm_p	GSC
pa180_c	GSC
pa181_c	GSC
5pg35pg_c	GSC
gmeACP_c	GSC
2dr1p_c	GSC
3ocddec5eACP_c	GSC
f6p_c	GSC
ocdca_p	GSC
1agpg120_p	GSC
mmcoa__S_c	GSC
aspsa_c	GSC
pa141_p	GSC
cdpdodec11eg_c	GSC
6pgc_c	GSC
hom__L_c	GSC
frulysp_c	GSC
all6p_c	GSC
2tdecg3p_c	GSC
etoh_c	GSC
cit_e	GSC
glu__L_c	GSC
4per_c	GSC
2sephchc_c	GSC
octapb_c	GSC
ocdcaACP_c	GSC
anhgm_c	GSC
ac_p	GSC
argsuc_c	GSC
dgtp_c	GSC
4c2me_c	GSC
hdcoa_c	GSC
sl26da_c	GSC
pa140_p	GSC
ahdt_c	GSC
g3p_c	GSC
dad_5_c	GSC
glyc__R_c	GSC
dtdp_c	GSC
hcys__L_c	GSC
anhgm3p_c	GSC
met__L_p	GSC
ara5p_c	GSC
asn__L_e	GSC
adphep_DD_c	GSC
6hmhptpp_c	GSC
tdecoa_c	GSC
hdceap_c	GSC
dpcoa_c	GSC
ppbng_c	GSC
trp__L_p	GSC
hxan_p	GSC
icolipa_c	GSC
lkdr_c	GSC
murein5px3p_p	GSC
utp_c	GSC
fdp_c	GSC
hpmeACP_c	GSC
imp_c	GSC
cpppg3_c	GSC
pg120_p	GSC
hlipa_c	GSC
phom_c	GSC
1tdec7eg3p_c	GSC
hdcea_c	GSC
gln__L_c	GSC
akg_p	GSC
23dhbzs_c	GSC
g1p_c	GSC
2agpg181_p	GSC
dnad_c	GSC
lys__L_p	GSC
o16a2und_p	GSC
3pg_c	GSC
hxa_p	GSC
1agpg181_p	GSC
ura_e	GSC
1agpg180_p	GSC
ggbutal_c	GSC
btcoa_c	GSC
3hcddec5eACP_c	GSC
pe181_p	GSC
odecoa_c	GSC
dxylnt_p	GSC
stcoa_c	GSC
murein4p3p_p	GSC
2agpe120_p	GSC
kphphhlipa_c	GSC
3oocoa_c	GSC
lgt__S_c	GSC
3hdcoa_c	GSC
u23ga_c	GSC
2agpg141_p	GSC
hdeACP_c	GSC
gal1p_c	GSC
13dpg_c	GSC
tyr__L_c	GSC
anhgm4p_p	GSC
1agpg141_p	GSC
anhm4p_c	GSC
4abut_p	GSC
acmanap_c	GSC
adn_p	GSC
anhm_c	GSC
6hmhpt_c	GSC
ppa_c	GSC
g3pg_p	GSC
2dh3dgal6p_c	GSC
hexACP_c	GSC
dcamp_c	GSC
rhcys_c	GSC
quln_c	GSC
acgam1p_c	GSC
ttdcea_c	GSC
ogmeACP_c	GSC
enter_p	GSC
xmp_c	GSC
3hmrsACP_c	GSC
glyald_e	GSC
uLa4n_c	GSC
4adcho_c	GSC
ppgpp_c	GSC
2cpr5p_c	GSC
g3pe_p	GSC
asn__L_p	GSC
fum_p	GSC
unagamuf_p	GSC
3hhexACP_c	GSC
ura_c	GSC
dha_e	GSC
acmum6p_c	GSC
tre6p_c	GSC
ade_c	GSC
dann_c	GSC
dxyl5p_c	GSC
pe141_c	GSC
adprib_c	GSC
cdpdtdecg_c	GSC
4abzglu_p	GSC
gggagicolipa_c	GSC
eca4und_p	GSC
sucglu_c	GSC
34hpp_c	GSC
glcn_p	GSC
kdolipid4_c	GSC
thym_c	GSC
acmalt_c	GSC
toctd2eACP_c	GSC
5aop_c	GSC
icit_c	GSC
amet_c	GSC
12dgr141_c	GSC
gthrd_e	GSC
hdcap_c	GSC
frdp_c	GSC
udcpdp_p	GSC
dutp_c	GSC
csn_c	GSC
12dgr161_c	GSC
ncam_c	GSC
2agpg160_c	GSC
amob_c	GSC
LalaDgluMdapDala_c	GSC
pg140_p	GSC
dca_c	GSC
pgp120_c	GSC
nac_c	GSC
cytd_p	GSC
alltn_c	GSC
pe120_p	GSC
ru5p__D_c	GSC
1hdec9eg3p_p	GSC
pgp181_c	GSC
1odecg3p_c	GSC
gthrd_p	GSC
t3c7mrseACP_c	GSC
etha_p	GSC
lipidA_c	GSC
anth_c	GSC
t3c11vaceACP_c	GSC
clpn180_p	GSC
dhpmp_c	GSC
val__L_p	GSC
lac__L_p	GSC
rml1p_c	GSC
acglu_c	GSC
glyc_p	GSC
pg160_c	GSC
LalaLglu_c	GSC
2ddg6p_c	GSC
pg161_p	GSC
glyald_c	GSC
acgam6p_c	GSC
udpgal_c	GSC
b2coa_c	GSC
clpn120_p	GSC
phthr_c	GSC
pant__R_c	GSC
ala__L_p	GSC
orot_c	GSC
rib__D_c	GSC
murein3px4p_p	GSC
tdeACP_c	GSC
pyr_p	GSC
murein3px3p_p	GSC
pgp140_c	GSC
colipa_c	GSC
ade_e	GSC
etha_c	GSC
cyst__L_c	GSC
aicar_c	GSC
gmhep17bp_c	GSC
2agpe140_c	GSC
pgp120_p	GSC
pgp161_p	GSC
malcoa_c	GSC
ocdcap_c	GSC
acon_T_c	GSC
2agpg180_c	GSC
pe161_p	GSC
r5p_c	GSC
gua_e	GSC
dgslnt_c	GSC
dhptdd_c	GSC
pan4p_c	GSC
ps180_c	GSC
5mta_c	GSC
glu5sa_c	GSC
dcacoa_c	GSC
hdd2coa_c	GSC
met__L_e	GSC
dmpp_c	GSC
fe3dcit_e	GSC
3otdcoa_c	GSC
oc2coa_c	GSC
clpn141_p	GSC
nad_c	GSC
ins_c	GSC
pa120_c	GSC
pa141_c	GSC
oaa_c	GSC
micit_c	GSC
2odec11eg3p_c	GSC
cdpdhdec9eg_c	GSC
arg__L_c	GSC
2dr5p_c	GSC
ps120_c	GSC
1agpe180_p	GSC
3hbcoa_c	GSC
thr__L_e	GSC
alaala_p	GSC
udcpgl_c	GSC
1tdecg3p_p	GSC
pmeACP_c	GSC
LalaDgluMdap_c	GSC
3odcoa_c	GSC
thex2eACP_c	GSC
1odec11eg3p_c	GSC
g3pg_c	GSC
prfp_c	GSC
4hthr_c	GSC
gly_c	GSC
5fthf_c	GSC
prbamp_c	GSC
glycogen_c	GSC
orn_p	GSC
murein4p4p_p	GSC
alltt_c	GSC
orot5p_c	GSC
2h3oppan_c	GSC
aragund_c	GSC
malthp_c	GSC
tdec2eACP_c	GSC
2hdecg3p_p	GSC
myrsACP_c	GSC
skm5p_c	GSC
2agpg160_p	GSC
ohpb_c	GSC
sucsal_c	GSC
aact_c	GSC
2agpe120_c	GSC
3htdcoa_c	GSC
clpn140_p	GSC
3psme_c	GSC
appl_c	GSC
pe141_p	GSC
pgp181_p	GSC
oxalcoa_c	GSC
12dgr120_p	GSC
pro__L_p	GSC
murein3p3p_p	GSC
1tdec7eg3p_p	GSC
anhgm3p_p	GSC
pe140_c	GSC
gly_e	GSC
unaga_c	GSC
lipa_c	GSC
12ppd__S_e	GSC
gdptp_c	GSC
gal_c	GSC
adphep_LD_c	GSC
hxcoa_c	GSC
asn__L_c	GSC
acald_e	GSC
fum_c	GSC
ptrc_p	GSC
nmn_c	GSC
h2mb4p_c	GSC
12dgr140_c	GSC
epmeACP_c	GSC
toct2eACP_c	GSC
ala_B_c	GSC
23dhba_c	GSC
cdpdodecg_c	GSC
5aizc_c	GSC
acald_p	GSC
1tdecg3p_c	GSC
hxan_e	GSC
t3c5ddeceACP_c	GSC
dudp_c	GSC
3haACP_c	GSC
eca3und_p	GSC
gtp_c	GSC
3ohexACP_c	GSC
cys__L_c	GSC
2agpg181_c	GSC
ocdca_c	GSC
uacmamu_c	GSC
2agpe180_c	GSC
2me4p_c	GSC
murein4px4px4p_p	GSC
glyc__R_e	GSC
udpgalfur_c	GSC
8aonn_c	GSC
alaala_e	GSC
5dglcn_e	GSC
succ_c	GSC
ump_c	GSC
pep_c	GSC
ahcys_c	GSC
colipa_p	GSC
1hdec9eg3p_c	GSC
xtp_c	GSC
thr__L_c	GSC
udpg_c	GSC
cdpdhdecg_c	GSC
mnl1p_c	GSC
acgam_c	GSC
acglc__D_c	GSC
25aics_c	GSC
2mcit_c	GSC
pimACP_c	GSC
acACP_c	GSC
pg181_p	GSC
udpLa4o_c	GSC
cdpdtdec7eg_c	GSC
ocdcea_c	GSC
r2hglut_c	GSC
uri_e	GSC
ppcoa_c	GSC
alltn_p	GSC
o16aund_p	GSC
cmp_c	GSC
pe160_c	GSC
dcdp_c	GSC
hx2coa_c	GSC
12dgr120_c	GSC
dad_2_c	GSC
murein4px4p4p_p	GSC
LalaDgluMdap_e	GSC
5caiz_c	GSC
1agpe160_p	GSC
ser__D_c	GSC
2obut_c	GSC
dxylnt_c	GSC
ttdca_c	GSC
pa180_p	GSC
cgly_c	GSC
maltttr_c	GSC
ala__L_e	GSC
ugmd_c	GSC
gam1p_c	GSC
malt_c	GSC
3oddecACP_c	GSC
glu5p_c	GSC
pram_c	GSC
um4p_c	GSC
23ddhb_c	GSC
10fthf_c	GSC
pmtcoa_c	GSC
glyclt_p	GSC
4ppcys_c	GSC
glc__D_c	GSC
dump_c	GSC
3omrsACP_c	GSC
cytd_c	GSC
unagamuf_c	GSC
3ooctdACP_c	GSC
idon__L_c	GSC
g6p_c	GSC
ppap_c	GSC
arg__L_e	GSC
2mcacn_c	GSC
gthox_c	GSC
3ocmrs7eACP_c	GSC
3ocvac11eACP_c	GSC
dtdpglu_c	GSC
lac__D_e	GSC
5dglcn_p	GSC
5dglcn_c	GSC
dtdp4d6dg_c	GSC
fum_e	GSC
metsox_S__L_c	GSC
dtbt_c	GSC
pg160_p	GSC
xan_e	GSC
g3pg_e	GSC
2agpe160_c	GSC
val__L_e	GSC
cdigmp_c	GSC
indole_c	GSC
fpram_c	GSC
glu__D_c	GSC
2agpg120_c	GSC
23dhmb_c	GSC
1agpg161_p	GSC
glyclt_c	GSC
pg161_c	GSC
hdcea_p	GSC
succ_e	GSC
gfgaragund_c	GSC
ametam_c	GSC
3ohdcoa_c	GSC
xu5p__D_c	GSC
fprica_c	GSC
ac_e	GSC
eca2und_p	GSC
gagicolipa_c	GSC
2dda7p_c	GSC
dhnpt_c	GSC
lac__L_e	GSC
12dgr180_p	GSC
2agpg140_p	GSC
lac__D_p	GSC
indole_e	GSC
3ohodcoa_c	GSC
alac__S_c	GSC
ddcap_c	GSC
etoh_e	GSC
feenter_e	GSC
3php_c	GSC
3ooctACP_c	GSC
dcmp_c	GSC
pe140_p	GSC
glyc__R_p	GSC
gslnt_c	GSC
dhap_c	GSC
butACP_c	GSC
2mecdp_c	GSC
lipa_p	GSC
pa160_c	GSC
adpglc_c	GSC
murein5p5p5p_p	GSC
2odec11eg3p_p	GSC
asp__L_p	GSC
murein4px4p_p	GSC
mercppyr_c	GSC
dctp_c	GSC
glucys_c	GSC
4abut_c	GSC
gdp_c	GSC
acser_c	GSC
1odec11eg3p_p	GSC
urdgci_c	GSC
met__L_c	GSC
akg_c	GSC
1odecg3p_p	GSC
12dgr181_p	GSC
o16a3und_p	GSC
pg180_p	GSC
ser__L_e	GSC
glyc_c	GSC
hdca_c	GSC
gam6p_c	GSC
pg141_c	GSC
g3pe_c	GSC
gmhep1p_c	GSC
lipidX_c	GSC
uacmam_c	GSC
pa120_p	GSC
murein5px4p_p	GSC
gcald_c	GSC
pg141_p	GSC
3hodcoa_c	GSC
prbatp_c	GSC
uLa4fn_c	GSC
dttp_c	GSC
1agpe141_p	GSC
ttdcea_p	GSC
ipdp_c	GSC
glyc3p_e	GSC
ins_p	GSC
pgp141_p	GSC
glyc3p_c	GSC
ocdceap_c	GSC
arg__L_p	GSC
ps161_c	GSC
1agpe181_p	GSC
mthgxl_c	GSC
6pgl_c	GSC
clpn161_p	GSC
urdglyc_c	GSC
4abut_e	GSC
dgmp_c	GSC
dtdp4d6dm_c	GSC
glu__L_p	GSC
tpalm2eACP_c	GSC
s17bp_c	GSC
xan_c	GSC
2tdec7eg3p_c	GSC
35cgmp_c	GSC
trp__L_c	GSC
o16aund_c	GSC
udcpdp_c	GSC
gua_p	GSC
glu__L_e	GSC
metsox_R__L_c	GSC
glyald_p	GSC
2amsa_c	GSC
gmhep7p_c	GSC
4abutn_c	GSC
2agpg180_p	GSC
ps160_c	GSC
etoh_p	GSC
sbt6p_c	GSC
maltpt_c	GSC
akg_e	GSC
egmeACP_c	GSC
kdo2lipid4_c	GSC
kdo_c	GSC
agm_e	GSC
tyr__L_e	GSC
murein5p4p_p	GSC
for_c	GSC
xtsn_e	GSC
methf_c	GSC
uamag_c	GSC
cys__L_p	GSC
1agpe161_p	GSC
glcn_e	GSC
ac_c	GSC
2hdec9eg3p_p	GSC
uaccg_c	GSC
dtdp4aaddg_c	GSC
12dgr160_c	GSC
gthrd_c	GSC
udpLa4n_c	GSC
thr__L_p	GSC
e4p_c	GSC
acg5sa_c	GSC
gg4abut_c	GSC
nicrnt_c	GSC
thdp_c	GSC
pa181_p	GSC
56dura_c	GSC
glcn_c	GSC
2agpe141_p	GSC
dd2coa_c	GSC
but2eACP_c	GSC
1agpe120_p	GSC
ala__D_e	GSC
1agpg160_p	GSC
asp__L_e	GSC
for_e	GSC
malACP_c	GSC
ddcacoa_c	GSC
ptrc_e	GSC
ps141_c	GSC
cddec5eACP_c	GSC
2hdecg3p_c	GSC
hmbil_c	GSC
bglycogen_c	GSC
val__L_c	GSC
acg5p_c	GSC
pppg9_c	GSC
dtmp_c	GSC
tddec2eACP_c	GSC
xtsn_c	GSC
ade_p	GSC
lipidAds_c	GSC
prlp_c	GSC
glx_c	GSC
dha_p	GSC
din_c	GSC
idon__L_p	GSC
feenter_c	GSC
allul6p_c	GSC
S2hglut_c	GSC
gdpmann_c	GSC
fe3dcit_p	GSC
cit_p	GSC
sl2a6o_c	GSC
2agpg161_p	GSC
26dap_LL_c	GSC
1hdecg3p_p	GSC
tagdp__D_c	GSC
man_c	GSC
coa_c	GSC
acald_c	GSC
od2coa_c	GSC
3dhsk_c	GSC
2ddara_c	GSC
2odecg3p_p	GSC
2agpg161_c	GSC
malttr_c	GSC
pgp160_c	GSC
dha_c	GSC
phphhlipa_c	GSC
sucgsa_c	GSC
cdp_c	GSC
nadp_c	GSC
gly_p	GSC
pyr_c	GSC
lac__L_c	GSC
acorn_c	GSC
ins_e	GSC
dhptdp_c	GSC
2hdec9eg3p_c	GSC
dhgly_c	GSC
ttdceap_c	GSC
hdca_p	GSC
uamr_c	GSC
ps181_c	GSC
octa_c	GSC
hgmeACP_c	GSC
u3aga_c	GSC
hpyr_c	GSC
dxylnt_e	GSC
udpglcur_c	GSC
ddca_c	GSC
xan_p	GSC
orn_c	GSC
lys__L_e	GSC
2agpe141_c	GSC
sucarg_c	GSC
1hdecg3p_c	GSC
adn_e	GSC
pe180_p	GSC
ala__D_c	GSC
2agpe161_p	GSC
tmrs2eACP_c	GSC
12dgr181_c	GSC
pnto__R_c	GSC
prpp_c	GSC
for_p	GSC
lys__L_c	GSC
forcoa_c	GSC
3dhq_c	GSC
12ppd__S_p	GSC
anhgm_e	GSC
gicolipa_c	GSC
ggagicolipa_c	GSC
r15bp_c	GSC
2pg_c	GSC
pa161_p	GSC
clpn181_p	GSC
mlthf_c	GSC
uri_c	GSC
pg181_c	GSC
cdpdddecg_c	GSC
ala__L_c	GSC
fgam_c	GSC
pgp141_c	GSC
23dhb_c	GSC
2agpe160_p	GSC
fc1p_c	GSC
occoa_c	GSC
oxur_c	GSC
murein5px4px4p_p	GSC
ura_p	GSC
amp_c	GSC
glyc_e	GSC
udpLa4fn_c	GSC
tre_c	GSC
s7p_c	GSC
feenter_p	GSC
12dgr141_p	GSC
pg180_c	GSC
u3hga_c	GSC
LalaDglu_c	GSC
2ddecg3p_c	GSC
sucorn_c	GSC
unagamu_c	GSC
thymd_p	GSC
orn_e	GSC
pe161_c	GSC
26dap__M_c	GSC
idon__L_e	GSC
4pasp_c	GSC
2tdec7eg3p_p	GSC
cit_c	GSC
3hddecACP_c	GSC
murein5p3p_p	GSC
2agpg141_c	GSC
LalaDgluMdap_p	GSC
agm_c	GSC
3hhdcoa_c	GSC
dhptd_c	GSC
chor_c	GSC
pa160_p	GSC
2agpe140_p	GSC
2agpe180_p	GSC
pro__L_e	GSC
2p4c2me_c	GSC
mal__L_p	GSC
pap_c	GSC
udp_c	GSC
cdec3eACP_c	GSC
pgp180_p	GSC
3hddcoa_c	GSC
alaala_c	GSC
12dgr140_p	GSC
aacoa_c	GSC
4abzglu_c	GSC
lac__D_c	GSC
3hdecACP_c	GSC
glyclt_e	GSC
ser__L_c	GSC
ptrc_c	GSC
cytd_e	GSC
accoa_c	GSC
1ddecg3p_p	GSC
ocdcea_p	GSC
pran_c	GSC
3hoctACP_c	GSC
1agpg140_p	GSC
octeACP_c	GSC
malthx_c	GSC
ser__L_p	GSC
g3pe_e	GSC
dhor__S_c	GSC
dtdprmn_c	GSC
urate_c	GSC
udcpp_c	GSC
4abzglu_e	GSC
dhf_c	GSC
dcyt_c	GSC
pg120_c	GSC
athr__L_c	GSC
garagund_c	GSC
2aobut_c	GSC
malcoame_c	GSC
enter_c	GSC
dtdp4addg_c	GSC
r1p_c	GSC
4ppan_c	GSC
man1p_c	GSC
glutrna_c	GSC
3ocpalm9eACP_c	GSC
3hoctaACP_c	GSC
2agpg120_p	GSC
indole_p	GSC
citr__L_c	GSC
gua_c	GSC
ctp_c	GSC
xtsn_p	GSC
2ddecg3p_p	GSC
t3c9palmeACP_c	GSC
pe160_p	GSC
enter_e	GSC
1agpe140_p	GSC
uppg3_c	GSC
man6p_c	GSC
gar_c	GSC
skm_c	GSC
uacgam_c	GSC
acon_C_c	GSC
hphhlipa_c	GSC
12dgr160_p	GSC
ghb_c	GSC
anhm3p_c	GSC
1ddecg3p_c	GSC
uri_p	GSC
thymd_e	GSC
glyc3p_p	GSC
3mob_c	GSC
pg140_c	GSC
palmACP_c	GSC
ocACP_c	GSC
pgp160_p	GSC
acmet_c	GSC
anhgm4p_c	GSC
actp_c	GSC
hxa_c	GSC
2odecg3p_c	GSC
36dahx_c	GSC
uaagmda_c	GSC
3ig3p_c	GSC
23dhdp_c	GSC
2agpg140_c	GSC
12dgr180_c	GSC
o16a4und_p	GSC
4abz_c	GSC
3hcvac11eACP_c	GSC
glu1sa_c	GSC
prpncoa_c	GSC
dc2coa_c	GSC
pe180_c	GSC
ala__D_p	GSC
2dhp_c	GSC
air_c	GSC
3hcmrs7eACP_c	GSC
thymd_c	GSC
etha_e	GSC
tyr__L_p	GSC
cys__L_e	GSC
2agpe161_c	GSC
murein5p5p_p	GSC
15dap_c	GSC
ggptrc_c	GSC
dhpt_c	GSC
dhmpt_c	GSC
uama_c	GSC
2agpe181_p	GSC
alltn_e	GSC
pa140_c	GSC
pser__L_c	GSC
LalaDgluMdapDala_p	GSC
udcpp_p	GSC
ichor_c	GSC
ckdo_c	GSC
clpn160_p	GSC
pa161_c	GSC
dcaACP_c	GSC
pgp180_c	GSC
3hpalmACP_c	GSC
duri_c	GSC
lald__L_c	GSC
gsn_p	GSC
ddca_p	GSC
thf_c	GSC
phhlipa_c	GSC
pyr_e	GSC
psd5p_c	GSC
ps140_c	GSC
td2coa_c	GSC
dhmptp_c	GSC
3oddcoa_c	GSC
tdcoa_c	GSC
pe120_c	GSC
pphn_c	GSC
hxan_c	GSC
ttdcap_c	GSC
3hcpalm9eACP_c	GSC
12dgr161_p	GSC
opmeACP_c	GSC
asp__L_c	GSC
12ppd__S_c	GSC
succoa_c	GSC
trp__L_e	GSC
uagmda_c	GSC
dgdp_c	GSC
LalaDgluMdapDala_e	GSC
3hhcoa_c	GSC
kdo8p_c	GSC
oxa_c	GSC
dgsn_c	GSC
uLa4n_p	GSC
2tdecg3p_p	GSC
puacgam_c	GSC
ugmda_c	GSC
grdp_c	GSC
cgly_p	GSC
ddcaACP_c	GSC
ttdca_p	GSC
actACP_c	GSC
agm_p	GSC
rmn_c	IN
Sfglutth_c	IN
cys__D_c	IN
peamn_p	IN
LalaDglu_p	IN
arbt_p	IN
aps_c	IN
xmp_p	IN
galur_c	IN
rephaccoa_c	IN
duri_e	IN
3hcinnm_p	IN
butso3_p	IN
cechddd_c	IN
3amp_e	IN
gal1p_e	IN
2pglyc_c	IN
cellb_e	IN
sq_e	IN
metglcur_e	IN
progly_e	IN
imp_e	IN
g3ps_c	IN
acnam_p	IN
atp_c	IN
sbt__D_e	IN
skm_e	IN
inost_c	IN
gp4g_c	IN
23cgmp_p	IN
acmana_e	IN
udpglcur_p	IN
pser__L_p	IN
fe3dcit_c	IN
2ddglcn_p	IN
glcur_c	IN
but_e	IN
g6p_e	IN
rmn_p	IN
2oxpaccoa_c	IN
6pgg_c	IN
cyan_c	IN
gal1p_p	IN
2ddglcn_e	IN
metsox_R__L_e	IN
maltpt_p	IN
fru_e	IN
25dkglcn_c	IN
arbt6p_c	IN
arab__L_p	IN
acgam1p_e	IN
xylu__L_c	IN
dcmp_p	IN
skm_p	IN
frulys_p	IN
psuri_c	IN
cellb_p	IN
cmp_p	IN
metsox_S__L_p	IN
isetac_p	IN
malt_p	IN
ala_B_p	IN
2dh3dgal_c	IN
op4en_c	IN
LalaLglu_p	IN
3dhgulnp_c	IN
manglyc_e	IN
cmp_e	IN
ethso3_p	IN
thrp_p	IN
LalaDglu_e	IN
fald_c	IN
psuri_p	IN
dcmp_e	IN
ascb6p_c	IN
pnto__R_e	IN
fuc__L_e	IN
ap5a_c	IN
isetac_c	IN
melib_p	IN
dhcinnm_c	IN
sbt__D_p	IN
26dap__M_e	IN
arab__L_c	IN
4h2opntn_c	IN
gam6p_p	IN
3ump_p	IN
gam6p_e	IN
23cgmp_e	IN
mchtbs6p_c	IN
fru_p	IN
rmn_e	IN
phaccoa_c	IN
xyl__D_e	IN
imp_p	IN
dadp_c	IN
dimp_p	IN
3ump_e	IN
mepn_e	IN
glcr_p	IN
tartr__L_c	IN
g3pi_e	IN
man6pglyc_c	IN
g3ps_e	IN
ppal_e	IN
arbt_e	IN
mnl_e	IN
progly_p	IN
dgmp_p	IN
galctn__D_c	IN
mal__D_e	IN
glyc2p_e	IN
gal_bD_p	IN
progly_c	IN
glcur1p_e	IN
cenchddd_c	IN
3cmp_p	IN
orot_p	IN
mmet_p	IN
Nmtrp_c	IN
iprimv_c	IN
psuri_e	IN
paps_c	IN
23ccmp_p	IN
gmp_e	IN
nmn_p	IN
ump_p	IN
cinnm_c	IN
r5p_p	IN
ocdcea_e	IN
mmet_c	IN
lcts_c	IN
lcts_p	IN
galctn__L_p	IN
dcyt_e	IN
sfp_c	IN
fcl__L_c	IN
malt_e	IN
acgam_e	IN
din_e	IN
dad_2_e	IN
rpntp_c	IN
sulfac_e	IN
2ddglcn_c	IN
amp_e	IN
man_p	IN
damp_p	IN
sarcs_c	IN
psclys_e	IN
3sala_c	IN
23dappa_p	IN
dgmp_e	IN
galur_p	IN
taur_e	IN
udpgal_p	IN
rml_c	IN
fuc__L_p	IN
galt_e	IN
udpg_e	IN
galctn__L_e	IN
tyrp_p	IN
xylu__D_c	IN
glyc2p_p	IN
dump_p	IN
urate_p	IN
dgsn_e	IN
minohp_p	IN
mepn_c	IN
acmum_p	IN
ser__D_p	IN
prcp_c	IN
hdca_e	IN
tre_p	IN
malthx_p	IN
tartr__L_e	IN
inost_p	IN
man6p_e	IN
xylu__L_p	IN
23camp_e	IN
fruur_e	IN
malttr_e	IN
nac_p	IN
glc__D_e	IN
acac_p	IN
altrn_c	IN
dca_p	IN
fald_e	IN
tartr__D_e	IN
dtmp_e	IN
ppal_p	IN
mal__D_p	IN
ascb__L_p	IN
galct__D_c	IN
udpgal_e	IN
tartr__D_p	IN
mso3_p	IN
galur_e	IN
minohp_e	IN
btal_c	IN
fruur_c	IN
14glucan_p	IN
g6p_p	IN
ttdcea_e	IN
metglcur_p	IN
man_e	IN
3oxdhscoa_c	IN
malttr_p	IN
sulfac_c	IN
taur_c	IN
ppa_p	IN
23dappa_e	IN
quin_p	IN
fuc__L_c	IN
acmana_c	IN
ala_B_e	IN
ascb__L_e	IN
dad_2_p	IN
glc__D_p	IN
isetac_e	IN
duri_p	IN
taur_p	IN
g3pc_c	IN
acnam_e	IN
uacgam_p	IN
gmp_p	IN
dimp_e	IN
14glucan_e	IN
oxadpcoa_c	IN
3dhguln_c	IN
mal__D_c	IN
fald_p	IN
ditp_c	IN
idp_c	IN
pppn_e	IN
acgam1p_p	IN
pppn_p	IN
pppn_c	IN
glcr_e	IN
23doguln_c	IN
ppa_e	IN
galctn__D_p	IN
malthx_e	IN
pnto__R_p	IN
maltpt_e	IN
26dap__M_p	IN
3cmp_e	IN
metglcur_c	IN
mi1p__D_c	IN
galct__D_p	IN
hmgth_c	IN
rib__D_p	IN
damp_e	IN
pacald_c	IN
psclys_c	IN
gal_p	IN
ethso3_c	IN
all__D_e	IN
mmet_e	IN
manglyc_p	IN
14glucan_c	IN
r5p_e	IN
sqg_c	IN
chtbs6p_c	IN
butso3_e	IN
glcur_p	IN
tre_e	IN
dcyt_p	IN
g3pc_e	IN
tartr__L_p	IN
mnl_p	IN
dump_e	IN
itp_c	IN
ocdca_e	IN
octa_p	IN
ser__D_e	IN
ap4a_c	IN
nmn_e	IN
5dh4dglc_c	IN
xyl__D_p	IN
gln__L_p	IN
melib_c	IN
ppal_c	IN
ragund_c	IN
din_p	IN
dtmp_p	IN
quin_c	IN
xu5p__L_c	IN
glcur_e	IN
galt_p	IN
g1p_e	IN
mana_c	IN
hkntd_c	IN
pser__L_e	IN
xmp_e	IN
octa_e	IN
ump_e	IN
gln__L_e	IN
amp_p	IN
tartr__D_c	IN
glcr_c	IN
LalaLglu_e	IN
acac_e	IN
tagur_c	IN
adp_c	IN
uacgam_e	IN
gam_p	IN
chtbs_p	IN
3gmp_p	IN
f6p_e	IN
galct__D_e	IN
gam_e	IN
pacald_e	IN
cys__D_p	IN
nac_e	IN
quin_e	IN
lyx__L_c	IN
sulfac_p	IN
but_p	IN
23doguln_p	IN
galt1p_c	IN
man6p_p	IN
metsox_S__L_e	IN
sq_c	IN
inost_e	IN
psclys_p	IN
g1p_p	IN
dca_e	IN
ethso3_e	IN
datp_c	IN
23cump_p	IN
cys__D_e	IN
3gmp_e	IN
orot_e	IN
sf_c	IN
mso3_c	IN
acmana_p	IN
3hadpcoa_c	IN
lyx__L_e	IN
pacald_p	IN
rbl__L_c	IN
fruur_p	IN
melib_e	IN
frulys_c	IN
dimp_c	IN
3amp_p	IN
tag6p__D_c	IN
g3pi_p	IN
lyx__L_p	IN
damp_c	IN
acac_c	IN
f1p_c	IN
2dhguln_c	IN
glcur1p_p	IN
tyrp_e	IN
3hcinnm_c	IN
f6p_p	IN
urate_e	IN
g3pc_p	IN
camp_c	IN
pac_c	IN
dhpppn_c	IN
acnam_c	IN
maltttr_p	IN
udpglcur_e	IN
peamn_e	IN
acgam_p	IN
gal_bD_e	IN
all__D_p	IN
gal_e	IN
23cump_e	IN
galctn__L_c	IN
prpmn_c	IN
mepn_p	IN
3hpppn_c	IN
glyc2p_c	IN
dxyl_c	IN
thrp_e	IN
3hpppn_p	IN
acmum_e	IN
csn_e	IN
g3pi_c	IN
dgsn_p	IN
23dappa_c	IN
sq_p	IN
maltttr_e	IN
chtbs_e	IN
xylu__L_e	IN
xyl__D_c	IN
hdcea_e	IN
23camp_p	IN
lcts_e	IN
dmbzid_c	IN
csn_p	IN
all__D_c	IN
ttdca_e	IN
23ccmp_e	IN
metsox_R__L_p	IN
ddca_e	IN
rib__D_e	IN
3hpppn_e	IN
hkndd_c	IN
mso3_e	IN
3hcinnm_e	IN
udpg_p	IN
23dhacoa_c	IN
g3ps_p	IN
frulys_e	IN
but_c	IN
arab__L_e	IN
galctn__D_e	IN
butso3_c	IN
3hpp_p	OUT
mptamp_c	OUT
phpyr_c	OUT
bmoco_c	OUT
mththf_e	OUT
mql8_c	OUT
hom__L_e	OUT
histd_c	OUT
dscl_c	OUT
urea_c	OUT
4crsol_c	OUT
mththf_c	OUT
gtspmd_c	OUT
mththf_p	OUT
rdmbzi_c	OUT
fecrm_un_p	OUT
sheme_c	OUT
2mahmp_c	OUT
cpg160_c	OUT
colipa_e	OUT
apg140_c	OUT
thmnp_c	OUT
his__L_p	OUT
pdx5p_c	OUT
5mtr_e	OUT
lipa_cold_p	OUT
acampnt_c	OUT
2omhmbl_c	OUT
kdo2lipid4_e	OUT
apg141_c	OUT
5aprbu_c	OUT
moadamp_c	OUT
fmn_p	OUT
gdpddman_c	OUT
fecrm_un_c	OUT
moco_c	OUT
thmmp_c	OUT
gdpofuc_c	OUT
imacp_c	OUT
scl_c	OUT
puacgam_p	OUT
cpgn_c	OUT
eig3p_c	OUT
15dap_e	OUT
cdg_c	OUT
bwco_c	OUT
gthox_e	OUT
colipap_e	OUT
poaac_c	OUT
db4p_c	OUT
apg161_c	OUT
thmpp_c	OUT
pheme_c	OUT
2dmmql8_c	OUT
mpt_c	OUT
pydx_c	OUT
wco_c	OUT
ribflv_p	OUT
cpe160_c	OUT
cbm_c	OUT
hemeO_c	OUT
25drapp_c	OUT
leu__L_p	OUT
apg120_c	OUT
kdo2lipid4_p	OUT
2ommbl_c	OUT
5mthf_c	OUT
ile__L_p	OUT
enlipa_p	OUT
preq0_c	OUT
5mtr_p	OUT
2tpr3dpcoa_c	OUT
2ombzl_c	OUT
lpp_p	OUT
gthox_p	OUT
feoxam_c	OUT
4ampm_c	OUT
phe__L_e	OUT
5apru_c	OUT
12ppd__R_p	OUT
cpmp_c	OUT
oxam_c	OUT
N1aspmd_c	OUT
bwcogdp_c	OUT
rbflvrd_c	OUT
thym_p	OUT
lipa_cold_e	OUT
cpgn_e	OUT
eca4colipa_p	OUT
hisp_c	OUT
cpgn_un_e	OUT
halipa_e	OUT
lald__D_c	OUT
eca4colipa_e	OUT
2ippm_c	OUT
btn_c	OUT
5prdmbz_c	OUT
moadcoo_c	OUT
preq1_c	OUT
3mop_c	OUT
arbtn_fe3_c	OUT
3c3hmp_c	OUT
arbtn_e	OUT
cpg180_c	OUT
acetol_c	OUT
meoh_c	OUT
pheme_p	OUT
pyam5p_c	OUT
dhna_c	OUT
bmocogdp_c	OUT
gdpfuc_c	OUT
lipa_cold_c	OUT
enlipa_e	OUT
cpe180_c	OUT
hacolipa_e	OUT
fecrm_c	OUT
acser_e	OUT
fad_c	OUT
arbtn_fe3_e	OUT
his__L_c	OUT
acser_p	OUT
q8_c	OUT
o16a4colipa_e	OUT
acolipa_e	OUT
athtp_c	OUT
dmlz_c	OUT
aconm_c	OUT
feoxam_un_p	OUT
ppp9_c	OUT
apg180_c	OUT
mdhdhf_c	OUT
octdp_c	OUT
cph4_c	OUT
3c2hmp_c	OUT
2ahbut_c	OUT
phe__L_c	OUT
lipopb_c	OUT
adocbl_c	OUT
sbzcoa_c	OUT
feoxam_p	OUT
fmnh2_c	OUT
aacald_c	OUT
bwco1gdp_c	OUT
2shchc_c	OUT
mqn8_c	OUT
4r5au_c	OUT
fmn_e	OUT
fecrm_p	OUT
cpgn_p	OUT
fecrm_e	OUT
15dap_p	OUT
3hpp_c	OUT
3amac_c	OUT
meoh_p	OUT
tcynt_c	OUT
colipap_p	OUT
urea_e	OUT
2ohph_c	OUT
fe3dhbzs3_c	OUT
apg181_c	OUT
arab__D_c	OUT
leu__L_e	OUT
uracp_c	OUT
cbl1_c	OUT
pheme_e	OUT
acanth_c	OUT
ile__L_e	OUT
xdp_c	OUT
4hbz_c	OUT
q8h2_c	OUT
pydxn_c	OUT
5drib_c	OUT
3ophb_c	OUT
pydam_c	OUT
lipa_e	OUT
12ppd__R_c	OUT
3c4mop_c	OUT
23dhbzs3_c	OUT
2oph_c	OUT
arbtn_fe3_p	OUT
mteo2_c	OUT
4hbz_p	OUT
fecrm_un_e	OUT
bmoco1gdp_c	OUT
cpgn_un_p	OUT
2omph_c	OUT
23dhmp_c	OUT
3hpp_e	OUT
his__L_e	OUT
feoxam_un_c	OUT
fad_e	OUT
thym_e	OUT
spmd_p	OUT
ile__L_c	OUT
acolipa_p	OUT
cxsam_c	OUT
ribflv_c	OUT
arbtn_p	OUT
fadh2_c	OUT
fad_p	OUT
12ppd__R_e	OUT
phe__L_p	OUT
cpgn_un_c	OUT
kdo2lipid4p_c	OUT
mococdp_c	OUT
n8aspmd_c	OUT
hom__L_p	OUT
erthrs_c	OUT
meoh_e	OUT
o16a4colipa_p	OUT
spmd_c	OUT
spmd_e	OUT
feoxam_e	OUT
mocogdp_c	OUT
moadcosh_c	OUT
4mop_c	OUT
arbtn_c	OUT
pydx5p_c	OUT
fmn_c	OUT
14dhncoa_c	OUT
leu__L_c	OUT
urea_p	OUT
apg160_c	OUT
rbl__D_c	OUT
feoxam_un_e	OUT
na15dap_c	OUT
sucbz_c	OUT
msa_c	OUT
4mpetz_c	OUT
5mtr_c	OUT
tma_p	IS
adocbl_p	IS
acgal_e	IS
ch4_p	IS
cbl1_e	IS
sucr_e	IS
nadph_c	IS
tmao_p	IS
fe3hox_e	IS
2hptcoa_c	IS
pydx_p	IS
gam_c	IS
novbcn_e	IS
thm_e	IS
gbbtn_c	IS
tma_e	IS
thm_c	IS
sla_c	IS
glyb_p	IS
gbbtn_p	IS
hqn_c	IS
cysi__L_e	IS
fe3dhbzs_p	IS
cbi_e	IS
tym_p	IS
fusa_e	IS
cm_p	IS
btn_e	IS
nadphx__R_c	IS
thm_p	IS
gdp_e	IS
crn__D_e	IS
pydxn_p	IS
crn__D_p	IS
mincyc_p	IS
malt6p_c	IS
dhptdn_c	IS
dms_p	IS
2dglc_e	IS
nalme_c	IS
bbtcoa_c	IS
cholate_p	IS
mercpeth_c	IS
adocbl_e	IS
gdp_p	IS
dhcur_c	IS
nadphx__S_c	IS
cholate_c	IS
dhcholn_c	IS
ttrcyc_e	IS
crncoa_c	IS
cur_c	IS
dmso_p	IS
didp_c	IS
agdpcbi_c	IS
cyan_e	IS
dmso_c	IS
cysi__L_p	IS
pydam_p	IS
cynt_p	IS
fusa_p	IS
betald_c	IS
ch4_c	IS
doxrbcn_e	IS
3hbz_c	IS
met__D_c	IS
cbi_c	IS
tcynt_p	IS
crn_p	IS
fe3dhbzs_e	IS
34dhpha_c	IS
novbcn_p	IS
pydx_e	IS
dopa_p	IS
tmao_c	IS
tym_e	IS
gtp_e	IS
dmso_e	IS
4ahmmp_c	IS
ctbtcoa_c	IS
2dglc_c	IS
4hoxpacd_p	IS
dhps_e	IS
ampnt_c	IS
acgal1p_e	IS
5phua_c	IS
dms_c	IS
acgal_p	IS
dhps_p	IS
thcur_c	IS
ctbt_p	IS
3hppnl_c	IS
34dhpac_e	IS
glyb_e	IS
adocbi_c	IS
udpacgal_p	IS
dms_e	IS
cbl1_p	IS
sucr_p	IS
13ppd_c	IS
thptdn_c	IS
crn_e	IS
lipoamp_c	IS
4mhetz_c	IS
crn__D_c	IS
dt5hsu_c	IS
mincyc_e	IS
tcynt_e	IS
ch4_e	IS
suc6p_c	IS
cysi__L_c	IS
chol_p	IS
fe3hox_p	IS
2dmmq8_c	IS
3hbzcoa_c	IS
5phdt_c	IS
ttrcyc_p	IS
2dglc_p	IS
cynt_e	IS
chol_e	IS
pydam_e	IS
fe3hox_un_p	IS
lipoate_p	IS
lipoate_c	IS
2doxg6p_c	IS
tmao_e	IS
cm_e	IS
fe3hox_un_c	IS
dtgcl_c	IS
fe3hox_un_e	IS
met__D_p	IS
adocbip_c	IS
fe3dhbzs3_p	IS
dkdglcn_c	IS
2hptcl_c	IS
met__D_e	IS
nadh_c	IS
btn_p	IS
cbi_p	IS
glyb_c	IS
lipoate_e	IS
pydxn_e	IS
cyan_p	IS
btnso_c	IS
gtp_p	IS
dopa_e	IS
acgal1p_p	IS
gmplys_c	IS
crn_c	IS
34dhpac_p	IS
fe3hox_c	IS
dhps_c	IS
udpacgal_e	IS
34dphacoa_c	IS
crnDcoa_c	IS
rfamp_p	IS
4hoxpacd_e	IS
tma_c	IS
rfamp_e	IS
nadhx__S_c	IS
cynt_c	IS
doxrbcn_p	IS
chol_c	IS
nadhx__R_c	IS
gbbtn_e	IS
ctbt_c	IS
