gsn_c	GSC
ru5p__L_c	GSC
pgp161_c	GSC
3opalmACP_c	GSC
pro__L_c	GSC
seramp_c	GSC
cgly_e	GSC
pgp140_p	GSC
fru_c	GSC
kdo2lipid4L_c	GSC
mal__L_c	GSC
hxa_e	GSC
gmp_c	GSC
mal__L_e	GSC
pe181_c	GSC
succ_p	GSC
adn_c	GSC
1pyr5c_c	GSC
3odecACP_c	GSC
3ohcoa_c	GSC
cbasp_c	GSC
cbp_c	GSC
2agpe181_c	GSC
3hocoa_c	GSC
anhgm_p	GSC
pa180_c	GSC
pa181_c	GSC
gmeACP_c	GSC
2dr1p_c	GSC
3ocddec5eACP_c	GSC
f6p_c	GSC
ocdca_p	GSC
mmcoa__S_c	GSC
aspsa_c	GSC
pa141_p	GSC
cdpdodec11eg_c	GSC
6pgc_c	GSC
hom__L_c	GSC
frulysp_c	GSC
2tdecg3p_c	GSC
etoh_c	GSC
glu__L_c	GSC
4per_c	GSC
cit_e	GSC
2sephchc_c	GSC
ocdcaACP_c	GSC
anhgm_c	GSC
ac_p	GSC
argsuc_c	GSC
dgtp_c	GSC
4c2me_c	GSC
hdcoa_c	GSC
sl26da_c	GSC
pa140_p	GSC
ahdt_c	GSC
g3p_c	GSC
dad_5_c	GSC
glyc__R_c	GSC
dtdp_c	GSC
hcys__L_c	GSC
6hmhptpp_c	GSC
anhgm3p_c	GSC
ara5p_c	GSC
asn__L_e	GSC
tdecoa_c	GSC
trp__L_p	GSC
hdceap_c	GSC
ppbng_c	GSC
dpcoa_c	GSC
hxan_p	GSC
murein5px3p_p	GSC
utp_c	GSC
fdp_c	GSC
hpmeACP_c	GSC
imp_c	GSC
cpppg3_c	GSC
pg120_p	GSC
phom_c	GSC
1tdec7eg3p_c	GSC
hdcea_c	GSC
gln__L_c	GSC
akg_p	GSC
23dhbzs_c	GSC
g1p_c	GSC
2agpg181_p	GSC
dnad_c	GSC
lys__L_p	GSC
3pg_c	GSC
hxa_p	GSC
ura_e	GSC
ggbutal_c	GSC
btcoa_c	GSC
3hcddec5eACP_c	GSC
pe181_p	GSC
odecoa_c	GSC
stcoa_c	GSC
murein4p3p_p	GSC
lgt__S_c	GSC
2agpe120_p	GSC
3oocoa_c	GSC
3hdcoa_c	GSC
u23ga_c	GSC
2agpg141_p	GSC
hdeACP_c	GSC
gal1p_c	GSC
13dpg_c	GSC
tyr__L_c	GSC
anhgm4p_p	GSC
4abut_p	GSC
anhm4p_c	GSC
acmanap_c	GSC
anhm_c	GSC
6hmhpt_c	GSC
hexACP_c	GSC
dcamp_c	GSC
quln_c	GSC
acgam1p_c	GSC
ttdcea_c	GSC
ogmeACP_c	GSC
enter_p	GSC
xmp_c	GSC
3hmrsACP_c	GSC
uLa4n_c	GSC
4adcho_c	GSC
ppgpp_c	GSC
2cpr5p_c	GSC
asn__L_p	GSC
unagamuf_p	GSC
3hhexACP_c	GSC
ura_c	GSC
dha_e	GSC
acmum6p_c	GSC
ade_c	GSC
dann_c	GSC
dxyl5p_c	GSC
pe141_c	GSC
adprib_c	GSC
cdpdtdecg_c	GSC
sucglu_c	GSC
34hpp_c	GSC
scys__L_c	GSC
kdolipid4_c	GSC
5aop_c	GSC
thym_c	GSC
acmalt_c	GSC
toctd2eACP_c	GSC
icit_c	GSC
amet_c	GSC
12dgr141_c	GSC
gthrd_e	GSC
hdcap_c	GSC
frdp_c	GSC
udcpdp_p	GSC
dutp_c	GSC
12dgr161_c	GSC
ncam_c	GSC
2agpg160_c	GSC
amob_c	GSC
LalaDgluMdapDala_c	GSC
dca_c	GSC
pg140_p	GSC
pgp120_c	GSC
nac_c	GSC
cytd_p	GSC
pe120_p	GSC
ru5p__D_c	GSC
pgp181_c	GSC
1odecg3p_c	GSC
gthrd_p	GSC
t3c7mrseACP_c	GSC
lipidA_c	GSC
anth_c	GSC
t3c11vaceACP_c	GSC
clpn180_p	GSC
dhpmp_c	GSC
lac__L_p	GSC
val__L_p	GSC
rml1p_c	GSC
acglu_c	GSC
glyc_p	GSC
pg160_c	GSC
LalaLglu_c	GSC
2ddg6p_c	GSC
pg161_p	GSC
acgam6p_c	GSC
udpgal_c	GSC
clpn120_p	GSC
b2coa_c	GSC
phthr_c	GSC
ala__L_p	GSC
pant__R_c	GSC
orot_c	GSC
rib__D_c	GSC
murein3px4p_p	GSC
tdeACP_c	GSC
pyr_p	GSC
murein3px3p_p	GSC
pgp140_c	GSC
ade_e	GSC
cyst__L_c	GSC
aicar_c	GSC
2agpe140_c	GSC
pgp161_p	GSC
pgp120_p	GSC
malcoa_c	GSC
ocdcap_c	GSC
acon_T_c	GSC
2agpg180_c	GSC
pe161_p	GSC
r5p_c	GSC
gua_e	GSC
dgslnt_c	GSC
pan4p_c	GSC
dcacoa_c	GSC
5mta_c	GSC
glu5sa_c	GSC
ps180_c	GSC
hdd2coa_c	GSC
dmpp_c	GSC
3otdcoa_c	GSC
oc2coa_c	GSC
clpn141_p	GSC
nad_c	GSC
ins_c	GSC
pa120_c	GSC
pa141_c	GSC
oaa_c	GSC
2odec11eg3p_c	GSC
cdpdhdec9eg_c	GSC
arg__L_c	GSC
2dr5p_c	GSC
ps120_c	GSC
3hbcoa_c	GSC
alaala_p	GSC
thr__L_e	GSC
1odec11eg3p_c	GSC
pmeACP_c	GSC
LalaDgluMdap_c	GSC
3odcoa_c	GSC
thex2eACP_c	GSC
g3pg_c	GSC
prfp_c	GSC
4hthr_c	GSC
gly_c	GSC
5fthf_c	GSC
prbamp_c	GSC
glycogen_c	GSC
orn_p	GSC
murein4p4p_p	GSC
orot5p_c	GSC
2h3oppan_c	GSC
malthp_c	GSC
tdec2eACP_c	GSC
2hdecg3p_p	GSC
skm5p_c	GSC
myrsACP_c	GSC
2agpg160_p	GSC
ohpb_c	GSC
sucsal_c	GSC
aact_c	GSC
2agpe120_c	GSC
3htdcoa_c	GSC
3psme_c	GSC
clpn140_p	GSC
pe141_p	GSC
pgp181_p	GSC
oxalcoa_c	GSC
12dgr120_p	GSC
pro__L_p	GSC
murein3p3p_p	GSC
anhgm3p_p	GSC
pe140_c	GSC
gly_e	GSC
unaga_c	GSC
lipa_c	GSC
12ppd__S_e	GSC
gdptp_c	GSC
gal_c	GSC
acald_e	GSC
asn__L_c	GSC
hxcoa_c	GSC
fum_c	GSC
ptrc_p	GSC
nmn_c	GSC
h2mb4p_c	GSC
12dgr140_c	GSC
epmeACP_c	GSC
toct2eACP_c	GSC
ala_B_c	GSC
23dhba_c	GSC
5aizc_c	GSC
cdpdodecg_c	GSC
acald_p	GSC
t3c5ddeceACP_c	GSC
2agpg181_c	GSC
1tdecg3p_c	GSC
dudp_c	GSC
3haACP_c	GSC
eca3und_p	GSC
gtp_c	GSC
3ohexACP_c	GSC
cys__L_c	GSC
hxan_e	GSC
ocdca_c	GSC
uacmamu_c	GSC
2agpe180_c	GSC
2me4p_c	GSC
murein4px4px4p_p	GSC
glyc__R_e	GSC
8aonn_c	GSC
alaala_e	GSC
succ_c	GSC
ump_c	GSC
pep_c	GSC
1hdec9eg3p_c	GSC
xtp_c	GSC
thr__L_c	GSC
udpg_c	GSC
cdpdhdecg_c	GSC
mnl1p_c	GSC
25aics_c	GSC
acgam_c	GSC
acglc__D_c	GSC
pimACP_c	GSC
acACP_c	GSC
pg181_p	GSC
cdpdtdec7eg_c	GSC
ocdcea_c	GSC
uri_e	GSC
ppcoa_c	GSC
cmp_c	GSC
pe160_c	GSC
dcdp_c	GSC
hx2coa_c	GSC
12dgr120_c	GSC
dad_2_c	GSC
murein4px4p4p_p	GSC
LalaDgluMdap_e	GSC
5caiz_c	GSC
ser__D_c	GSC
2obut_c	GSC
ttdca_c	GSC
pa180_p	GSC
cgly_c	GSC
maltttr_c	GSC
ala__L_e	GSC
ugmd_c	GSC
gam1p_c	GSC
malt_c	GSC
3oddecACP_c	GSC
glu5p_c	GSC
10fthf_c	GSC
pram_c	GSC
23ddhb_c	GSC
um4p_c	GSC
pmtcoa_c	GSC
4ppcys_c	GSC
glc__D_c	GSC
dump_c	GSC
3omrsACP_c	GSC
cytd_c	GSC
3ooctdACP_c	GSC
unagamuf_c	GSC
g6p_c	GSC
arg__L_e	GSC
gthox_c	GSC
3ocmrs7eACP_c	GSC
3ocvac11eACP_c	GSC
dtdpglu_c	GSC
lac__D_e	GSC
dtdp4d6dg_c	GSC
dtbt_c	GSC
metsox_S__L_c	GSC
pg160_p	GSC
xan_e	GSC
quin_p	GSC
2agpe160_c	GSC
indole_c	GSC
val__L_e	GSC
fpram_c	GSC
glu__D_c	GSC
2agpg120_c	GSC
23dhmb_c	GSC
hdcea_p	GSC
pg161_c	GSC
succ_e	GSC
ametam_c	GSC
3ohdcoa_c	GSC
xu5p__D_c	GSC
fprica_c	GSC
ac_e	GSC
eca2und_p	GSC
dhnpt_c	GSC
2dda7p_c	GSC
lac__L_e	GSC
indole_e	GSC
lac__D_p	GSC
2agpg140_p	GSC
4hthr_p	GSC
3ohodcoa_c	GSC
12dgr180_p	GSC
alac__S_c	GSC
etoh_e	GSC
ddcap_c	GSC
feenter_e	GSC
3php_c	GSC
3ooctACP_c	GSC
dcmp_c	GSC
pe140_p	GSC
glyc__R_p	GSC
gslnt_c	GSC
dhap_c	GSC
butACP_c	GSC
2mecdp_c	GSC
lipa_p	GSC
pa160_c	GSC
adpglc_c	GSC
murein5p5p5p_p	GSC
2odec11eg3p_p	GSC
asp__L_p	GSC
murein4px4p_p	GSC
dctp_c	GSC
glucys_c	GSC
4abut_c	GSC
gdp_c	GSC
acser_c	GSC
met__L_c	GSC
akg_c	GSC
12dgr181_p	GSC
ser__L_e	GSC
pg180_p	GSC
glyc_c	GSC
hdca_c	GSC
gam6p_c	GSC
pg141_c	GSC
g3pe_c	GSC
lipidX_c	GSC
uacmam_c	GSC
pa120_p	GSC
murein5px4p_p	GSC
gcald_c	GSC
pg141_p	GSC
3hodcoa_c	GSC
prbatp_c	GSC
uLa4fn_c	GSC
ttdcea_p	GSC
dttp_c	GSC
ipdp_c	GSC
pgp141_p	GSC
glyc3p_c	GSC
ocdceap_c	GSC
ps161_c	GSC
arg__L_p	GSC
mthgxl_c	GSC
6pgl_c	GSC
clpn161_p	GSC
4abut_e	GSC
dgmp_c	GSC
s17bp_c	GSC
glu__L_p	GSC
2tdec7eg3p_c	GSC
tpalm2eACP_c	GSC
xan_c	GSC
indpyr_c	GSC
35cgmp_c	GSC
trp__L_c	GSC
gua_p	GSC
udcpdp_c	GSC
metsox_R__L_c	GSC
glu__L_e	GSC
2amsa_c	GSC
4abutn_c	GSC
2agpg180_p	GSC
etoh_p	GSC
ps160_c	GSC
sbt6p_c	GSC
maltpt_c	GSC
akg_e	GSC
egmeACP_c	GSC
kdo2lipid4_c	GSC
kdo_c	GSC
tyr__L_e	GSC
agm_e	GSC
murein5p4p_p	GSC
for_c	GSC
xtsn_e	GSC
methf_c	GSC
uamag_c	GSC
cys__L_p	GSC
ac_c	GSC
2hdec9eg3p_p	GSC
uaccg_c	GSC
dtdp4aaddg_c	GSC
12dgr160_c	GSC
gthrd_c	GSC
e4p_c	GSC
thr__L_p	GSC
gg4abut_c	GSC
acg5sa_c	GSC
nicrnt_c	GSC
thdp_c	GSC
pa181_p	GSC
2agpe141_p	GSC
dd2coa_c	GSC
56dura_c	GSC
but2eACP_c	GSC
ala__D_e	GSC
asp__L_e	GSC
for_e	GSC
malACP_c	GSC
hmbil_c	GSC
ddcacoa_c	GSC
ps141_c	GSC
cddec5eACP_c	GSC
2hdecg3p_c	GSC
ptrc_e	GSC
bglycogen_c	GSC
val__L_c	GSC
pppg9_c	GSC
acg5p_c	GSC
dtmp_c	GSC
tddec2eACP_c	GSC
xtsn_c	GSC
ade_p	GSC
lipidAds_c	GSC
prlp_c	GSC
glx_c	GSC
dha_p	GSC
din_c	GSC
feenter_c	GSC
gdpmann_c	GSC
sl2a6o_c	GSC
cit_p	GSC
2agpg161_p	GSC
26dap_LL_c	GSC
tagdp__D_c	GSC
man_c	GSC
coa_c	GSC
acald_c	GSC
od2coa_c	GSC
2agpg161_c	GSC
3dhsk_c	GSC
2odecg3p_p	GSC
malttr_c	GSC
pgp160_c	GSC
dha_c	GSC
sucgsa_c	GSC
cdp_c	GSC
nadp_c	GSC
gly_p	GSC
pyr_c	GSC
lac__L_c	GSC
acorn_c	GSC
2hdec9eg3p_c	GSC
quin_c	GSC
ttdceap_c	GSC
hdca_p	GSC
uamr_c	GSC
ps181_c	GSC
octa_c	GSC
hgmeACP_c	GSC
u3aga_c	GSC
hpyr_c	GSC
4hthr_e	GSC
ddca_c	GSC
xan_p	GSC
orn_c	GSC
lys__L_e	GSC
2agpe141_c	GSC
sucarg_c	GSC
1hdecg3p_c	GSC
pe180_p	GSC
ala__D_c	GSC
2agpe161_p	GSC
tmrs2eACP_c	GSC
12ppd__S_p	GSC
prpp_c	GSC
12dgr181_c	GSC
3dhq_c	GSC
lys__L_c	GSC
for_p	GSC
forcoa_c	GSC
pnto__R_c	GSC
anhgm_e	GSC
2pg_c	GSC
pa161_p	GSC
clpn181_p	GSC
mlthf_c	GSC
uri_c	GSC
pg181_c	GSC
cdpdddecg_c	GSC
ala__L_c	GSC
fgam_c	GSC
23dhb_c	GSC
pgp141_c	GSC
quin_e	GSC
2agpe160_p	GSC
fc1p_c	GSC
occoa_c	GSC
murein5px4px4p_p	GSC
ura_p	GSC
amp_c	GSC
glyc_e	GSC
pg180_c	GSC
feenter_p	GSC
s7p_c	GSC
12dgr141_p	GSC
u3hga_c	GSC
LalaDglu_c	GSC
2ddecg3p_c	GSC
sucorn_c	GSC
unagamu_c	GSC
orn_e	GSC
pe161_c	GSC
26dap__M_c	GSC
4pasp_c	GSC
2tdec7eg3p_p	GSC
cit_c	GSC
3hddecACP_c	GSC
murein5p3p_p	GSC
2agpg141_c	GSC
LalaDgluMdap_p	GSC
agm_c	GSC
3hhdcoa_c	GSC
chor_c	GSC
pa160_p	GSC
2agpe140_p	GSC
2agpe180_p	GSC
pro__L_e	GSC
2p4c2me_c	GSC
mal__L_p	GSC
pap_c	GSC
udp_c	GSC
cdec3eACP_c	GSC
pgp180_p	GSC
3hddcoa_c	GSC
aacoa_c	GSC
12dgr140_p	GSC
alaala_c	GSC
lac__D_c	GSC
3hdecACP_c	GSC
ser__L_c	GSC
ptrc_c	GSC
cytd_e	GSC
accoa_c	GSC
ocdcea_p	GSC
pran_c	GSC
3hoctACP_c	GSC
octeACP_c	GSC
malthx_c	GSC
ser__L_p	GSC
dhor__S_c	GSC
udcpp_c	GSC
dhf_c	GSC
dcyt_c	GSC
pg120_c	GSC
athr__L_c	GSC
2aobut_c	GSC
malcoame_c	GSC
enter_c	GSC
dtdp4addg_c	GSC
4ppan_c	GSC
man1p_c	GSC
r1p_c	GSC
glutrna_c	GSC
3ocpalm9eACP_c	GSC
3hoctaACP_c	GSC
2agpg120_p	GSC
indole_p	GSC
citr__L_c	GSC
xtsn_p	GSC
ctp_c	GSC
gua_c	GSC
2ddecg3p_p	GSC
t3c9palmeACP_c	GSC
pe160_p	GSC
enter_e	GSC
uppg3_c	GSC
man6p_c	GSC
skm_c	GSC
gar_c	GSC
uacgam_c	GSC
acon_C_c	GSC
12dgr160_p	GSC
ghb_c	GSC
anhm3p_c	GSC
1ddecg3p_c	GSC
uri_p	GSC
3mob_c	GSC
palmACP_c	GSC
pg140_c	GSC
ocACP_c	GSC
pgp160_p	GSC
anhgm4p_c	GSC
actp_c	GSC
hxa_c	GSC
2odecg3p_c	GSC
uaagmda_c	GSC
3ig3p_c	GSC
23dhdp_c	GSC
2agpg140_c	GSC
12dgr180_c	GSC
4abz_c	GSC
3hcvac11eACP_c	GSC
glu1sa_c	GSC
dc2coa_c	GSC
pe180_c	GSC
ala__D_p	GSC
2dhp_c	GSC
air_c	GSC
3hcmrs7eACP_c	GSC
thymd_c	GSC
tyr__L_p	GSC
cys__L_e	GSC
2agpe161_c	GSC
dhmpt_c	GSC
murein5p5p_p	GSC
ggptrc_c	GSC
15dap_c	GSC
dhpt_c	GSC
uama_c	GSC
2agpe181_p	GSC
pa140_c	GSC
pser__L_c	GSC
LalaDgluMdapDala_p	GSC
ckdo_c	GSC
ichor_c	GSC
udcpp_p	GSC
clpn160_p	GSC
pa161_c	GSC
dcaACP_c	GSC
pgp180_c	GSC
3hpalmACP_c	GSC
duri_c	GSC
lald__L_c	GSC
ddca_p	GSC
thf_c	GSC
ps140_c	GSC
pyr_e	GSC
td2coa_c	GSC
dhmptp_c	GSC
3oddcoa_c	GSC
12dgr161_p	GSC
pe120_c	GSC
pphn_c	GSC
hxan_c	GSC
tdcoa_c	GSC
3hcpalm9eACP_c	GSC
ttdcap_c	GSC
opmeACP_c	GSC
asp__L_c	GSC
12ppd__S_c	GSC
succoa_c	GSC
trp__L_e	GSC
uagmda_c	GSC
dgdp_c	GSC
LalaDgluMdapDala_e	GSC
3hhcoa_c	GSC
kdo8p_c	GSC
oxa_c	GSC
dgsn_c	GSC
uLa4n_p	GSC
2tdecg3p_p	GSC
ugmda_c	GSC
grdp_c	GSC
cgly_p	GSC
ddcaACP_c	GSC
agm_p	GSC
ttdca_p	GSC
actACP_c	GSC
octapb_c	GSC
rmn_c	IN
cys__D_c	IN
LalaDglu_p	IN
gsn_e	IN
arbt_p	IN
aps_c	IN
xmp_p	IN
galur_c	IN
iasp_c	IN
duri_e	IN
suchms_c	IN
galam_e	IN
3amp_e	IN
gal1p_e	IN
fe3dhbzs_p	IN
progly_e	IN
imp_e	IN
acnam_p	IN
g3ps_c	IN
atp_c	IN
skm_e	IN
gp4g_c	IN
23cgmp_p	IN
acmana_e	IN
udpglcur_p	IN
pser__L_p	IN
2ddglcn_p	IN
glcur_c	IN
g6p_e	IN
met__L_p	IN
rmn_p	IN
gal1p_p	IN
2ddglcn_e	IN
metsox_R__L_e	IN
maltpt_p	IN
fru_e	IN
arbt6p_c	IN
25dkglcn_c	IN
acgam1p_e	IN
xylu__L_c	IN
dcmp_p	IN
skm_p	IN
frulys_p	IN
34dhpha_c	IN
cmp_p	IN
metsox_S__L_p	IN
isetac_p	IN
malt_p	IN
ala_B_p	IN
LalaLglu_p	IN
3dhgulnp_c	IN
galam_p	IN
acgal1p_e	IN
manglyc_e	IN
cmp_e	IN
ethso3_p	IN
thrp_p	IN
udpacgal_p	IN
dxyl_e	IN
sucr_p	IN
adn_p	IN
LalaDglu_e	IN
dcmp_e	IN
g3pg_p	IN
ascb6p_c	IN
pnto__R_e	IN
rhcys_c	IN
ap5a_c	IN
suc6p_c	IN
isetac_c	IN
melib_p	IN
26dap__M_e	IN
g3pe_p	IN
fum_p	IN
3ump_p	IN
gam6p_p	IN
gam6p_e	IN
23cgmp_e	IN
tre6p_c	IN
fru_p	IN
rmn_e	IN
glcn_p	IN
imp_p	IN
dadp_c	IN
dimp_p	IN
3hoxpac_c	IN
3ump_e	IN
glcr_p	IN
tartr__L_c	IN
chit6p_c	IN
man6pglyc_c	IN
g3pi_e	IN
g3ps_e	IN
arbt_e	IN
mnl_e	IN
progly_p	IN
dgmp_p	IN
glyc2p_e	IN
gal_bD_p	IN
progly_c	IN
glcur1p_e	IN
3cmp_p	IN
orot_p	IN
Nmtrp_c	IN
2ohed_c	IN
paps_c	IN
rnam_c	IN
23ccmp_p	IN
gmp_e	IN
nmn_p	IN
ump_p	IN
r5p_p	IN
oaa_e	IN
colipa_c	IN
ocdcea_e	IN
lcts_p	IN
lcts_c	IN
dcyt_e	IN
met__L_e	IN
malt_e	IN
acgam_e	IN
din_e	IN
dad_2_e	IN
sulfac_e	IN
2ddglcn_c	IN
4h2kpi_c	IN
amp_e	IN
man_p	IN
damp_p	IN
sarcs_c	IN
psclys_e	IN
3sala_c	IN
dgmp_e	IN
fe3dhbzs_c	IN
galur_p	IN
tag1p__D_c	IN
alltt_c	IN
24dhhed_c	IN
taur_e	IN
udpgal_p	IN
rml_c	IN
galt_e	IN
udpg_e	IN
tyrp_p	IN
xylu__D_c	IN
glyc2p_p	IN
dump_p	IN
dgsn_e	IN
acmum_p	IN
ser__D_p	IN
hdca_e	IN
2kmb_c	IN
tre_p	IN
malthx_p	IN
tartr__L_e	IN
man6p_e	IN
xylu__L_p	IN
23camp_e	IN
ahcys_c	IN
colipa_p	IN
fruur_e	IN
malttr_e	IN
nac_p	IN
glc__D_e	IN
udpLa4o_c	IN
acgal6p_c	IN
altrn_c	IN
dca_p	IN
tartr__D_e	IN
dtmp_e	IN
ascb__L_p	IN
galct__D_c	IN
5cohe_c	IN
udpgal_e	IN
tartr__D_p	IN
4hphac_p	IN
galur_e	IN
fruur_c	IN
14glucan_p	IN
4hphac_c	IN
g6p_p	IN
ttdcea_e	IN
man_e	IN
udpacgal_e	IN
malttr_p	IN
sulfac_c	IN
taur_c	IN
fum_e	IN
g3pg_e	IN
acmana_c	IN
ala_B_e	IN
ascb__L_e	IN
dad_2_p	IN
glc__D_p	IN
sucr_e	IN
isetac_e	IN
duri_p	IN
taur_p	IN
g3pc_c	IN
acnam_e	IN
uacgam_p	IN
gmp_p	IN
dimp_e	IN
14glucan_e	IN
oxadpcoa_c	IN
ditp_c	IN
idp_c	IN
acgam1p_p	IN
glcr_e	IN
malthx_e	IN
pnto__R_p	IN
maltpt_e	IN
26dap__M_p	IN
3cmp_e	IN
glyc3p_e	IN
galct__D_p	IN
ins_p	IN
rib__D_p	IN
urdglyc_c	IN
damp_e	IN
psclys_c	IN
gal_p	IN
ethso3_c	IN
fe3dhbzs_e	IN
manglyc_p	IN
glcn_e	IN
raffin_p	IN
14glucan_c	IN
r5p_e	IN
udpLa4n_c	IN
chtbs6p_c	IN
dxyl_p	IN
glcn_c	IN
glcur_p	IN
tre_e	IN
dcyt_p	IN
g3pc_e	IN
tartr__L_p	IN
mnl_p	IN
dump_e	IN
itp_c	IN
3hoxpac_e	IN
ocdca_e	IN
octa_p	IN
ser__D_e	IN
ap4a_c	IN
nmn_e	IN
5dh4dglc_c	IN
gln__L_p	IN
melib_c	IN
din_p	IN
dtmp_p	IN
ins_e	IN
xu5p__L_c	IN
glcur_e	IN
galt_p	IN
g1p_e	IN
mana_c	IN
pser__L_e	IN
xmp_e	IN
udpglcur_c	IN
octa_e	IN
rnam_p	IN
ump_e	IN
acgal1p_p	IN
gln__L_e	IN
adn_e	IN
amp_p	IN
tartr__D_c	IN
glcr_c	IN
oaa_p	IN
LalaLglu_e	IN
tagur_c	IN
2hh24dd_c	IN
adp_c	IN
uacgam_e	IN
gam_p	IN
chtbs_p	IN
3gmp_p	IN
f6p_e	IN
galct__D_e	IN
gam_e	IN
acgal_e	IN
cys__D_p	IN
nac_e	IN
lyx__L_c	IN
oxur_c	IN
sulfac_p	IN
3hoxpac_p	IN
5cmhm_c	IN
raffin_e	IN
udpLa4fn_c	IN
tre_c	IN
galt1p_c	IN
man6p_p	IN
metsox_S__L_e	IN
thymd_p	IN
galam6p_c	IN
psclys_p	IN
g1p_p	IN
dca_e	IN
ethso3_e	IN
datp_c	IN
23cump_p	IN
cys__D_e	IN
3gmp_e	IN
orot_e	IN
acmana_p	IN
lyx__L_e	IN
rbl__L_c	IN
fruur_p	IN
melib_e	IN
frulys_c	IN
dimp_c	IN
3amp_p	IN
tag6p__D_c	IN
g3pi_p	IN
lyx__L_p	IN
damp_c	IN
f1p_c	IN
2dhguln_c	IN
g3pe_e	IN
glcur1p_p	IN
tyrp_e	IN
f6p_p	IN
g3pc_p	IN
camp_c	IN
raffin_c	IN
acnam_c	IN
acgal_p	IN
maltttr_p	IN
udpglcur_e	IN
glyc3p_p	IN
acgam_p	IN
thymd_e	IN
gal_bD_e	IN
gal_e	IN
23cump_e	IN
5cmhmsa_c	IN
glyc2p_c	IN
dxyl_c	IN
thrp_e	IN
acmum_e	IN
g3pi_c	IN
dgsn_p	IN
maltttr_e	IN
chitob_p	IN
chtbs_e	IN
xylu__L_e	IN
hdcea_e	IN
23camp_p	IN
lcts_e	IN
dmbzid_c	IN
gsn_p	IN
ttdca_e	IN
23ccmp_e	IN
metsox_R__L_p	IN
ddca_e	IN
rib__D_e	IN
sucr_c	IN
udpg_p	IN
4hphac_e	IN
g3ps_p	IN
frulys_e	IN
cdigmp_c	OUT
3hpp_p	OUT
hhlipa_c	OUT
mptamp_c	OUT
phpyr_c	OUT
1agpg161_p	OUT
bmoco_c	OUT
glyclt_c	OUT
mql8_c	OUT
hom__L_e	OUT
histd_c	OUT
dscl_c	OUT
urea_c	OUT
4crsol_c	OUT
gtspmd_c	OUT
etha_c	OUT
gmhep17bp_c	OUT
argtrna_c	OUT
rdmbzi_c	OUT
fecrm_un_p	OUT
sheme_c	OUT
2mahmp_c	OUT
cpg160_c	OUT
valtrna_c	OUT
glntrna_c	OUT
apg140_c	OUT
thmnp_c	OUT
phetrna_c	OUT
his__L_p	OUT
pdx5p_c	OUT
5mtr_e	OUT
asntrna_c	OUT
lipa_cold_p	OUT
2omhmbl_c	OUT
kdo2lipid4_e	OUT
apg141_c	OUT
5aprbu_c	OUT
moadamp_c	OUT
thrtrna_c	OUT
adocblp_c	OUT
gdpddman_c	OUT
fecrm_un_c	OUT
srb1p_c	OUT
moco_c	OUT
1agpg120_p	OUT
thmmp_c	OUT
gdpofuc_c	OUT
imacp_c	OUT
scl_c	OUT
eig3p_c	OUT
15dap_e	OUT
cdg_c	OUT
bwco_c	OUT
gthox_e	OUT
1odec11eg3p_p	OUT
colipap_e	OUT
fmettrna_c	OUT
1odecg3p_p	OUT
poaac_c	OUT
apg161_c	OUT
db4p_c	OUT
1agpe180_p	OUT
thmpp_c	OUT
pheme_c	OUT
2dmmql8_c	OUT
mpt_c	OUT
1tdecg3p_p	OUT
pydx_c	OUT
wco_c	OUT
sectrna_c	OUT
cbm_c	OUT
cpe160_c	OUT
25drapp_c	OUT
gmhep1p_c	OUT
hemeO_c	OUT
leu__L_p	OUT
apg120_c	OUT
kdo2lipid4_p	OUT
2ommbl_c	OUT
5mthf_c	OUT
ile__L_p	OUT
asptrna_c	OUT
enlipa_p	OUT
preq0_c	OUT
5mtr_p	OUT
2tpr3dpcoa_c	OUT
2ombzl_c	OUT
lpp_p	OUT
adphep_DD_c	OUT
gthox_p	OUT
feoxam_c	OUT
glyclt_e	OUT
4ampm_c	OUT
1agpe141_p	OUT
5apru_c	OUT
phe__L_e	OUT
leutrna_c	OUT
aragund_c	OUT
1agpe181_p	OUT
1ddecg3p_p	OUT
cpmp_c	OUT
lipa_cold_e	OUT
1agpg140_p	OUT
bwcogdp_c	OUT
rbflvrd_c	OUT
thym_p	OUT
cpgn_e	OUT
dtdp4d6dm_c	OUT
hisp_c	OUT
hlipa_c	OUT
urate_c	OUT
cpgn_un_e	OUT
dtdprmn_c	OUT
o16aund_c	OUT
halipa_e	OUT
alatrna_c	OUT
2ippm_c	OUT
gmhep7p_c	OUT
histrna_c	OUT
btn_c	OUT
5prdmbz_c	OUT
moadcoo_c	OUT
preq1_c	OUT
3mop_c	OUT
trptrna_c	OUT
cpg180_c	OUT
1tdec7eg3p_p	OUT
arbtn_fe3_c	OUT
3c3hmp_c	OUT
arbtn_e	OUT
4hba_c	OUT
1agpg181_p	OUT
acetol_c	OUT
meoh_c	OUT
pheme_p	OUT
pyam5p_c	OUT
dhna_c	OUT
bmocogdp_c	OUT
1agpg180_p	OUT
lipa_cold_c	OUT
gdpfuc_c	OUT
cpe180_c	OUT
adphep_LD_c	OUT
1agpe161_p	OUT
enlipa_e	OUT
fecrm_c	OUT
acser_e	OUT
fad_c	OUT
arbtn_fe3_e	OUT
his__L_c	OUT
acser_p	OUT
1agpe140_p	OUT
q8_c	OUT
acolipa_e	OUT
athtp_c	OUT
dmlz_c	OUT
aconm_c	OUT
feoxam_un_p	OUT
ppp9_c	OUT
apg180_c	OUT
octdp_c	OUT
cph4_c	OUT
3c2hmp_c	OUT
2ahbut_c	OUT
phe__L_c	OUT
lipopb_c	OUT
adocbl_c	OUT
sbzcoa_c	OUT
feoxam_p	OUT
fmnh2_c	OUT
aacald_c	OUT
bwco1gdp_c	OUT
hphhlipa_c	OUT
2shchc_c	OUT
mqn8_c	OUT
4r5au_c	OUT
1agpg141_p	OUT
fecrm_p	OUT
1agpe120_p	OUT
fecrm_e	OUT
mettrna_c	OUT
15dap_p	OUT
3hpp_c	OUT
cystrna_c	OUT
1agpg160_p	OUT
ppa_c	OUT
3amac_c	OUT
meoh_p	OUT
colipap_p	OUT
urea_e	OUT
2ohph_c	OUT
2hyoxplac_c	OUT
apg181_c	OUT
leu__L_e	OUT
uracp_c	OUT
cbl1_c	OUT
pheme_e	OUT
ile__L_e	OUT
2oph_c	OUT
4hbz_c	OUT
q8h2_c	OUT
1hdecg3p_p	OUT
pydxn_c	OUT
5drib_c	OUT
3ophb_c	OUT
pydam_c	OUT
eca4und_p	OUT
gggagicolipa_c	OUT
mmcoa__R_c	OUT
lipa_e	OUT
3c4mop_c	OUT
23dhbzs3_c	OUT
lystrna_c	OUT
sertrna_c	OUT
1agpe160_p	OUT
arbtn_fe3_p	OUT
fecrm_un_e	OUT
3hpp_e	OUT
bmoco1gdp_c	OUT
cpgn_un_p	OUT
2omph_c	OUT
23dhmp_c	OUT
dhgly_c	OUT
his__L_e	OUT
feoxam_un_c	OUT
thym_e	OUT
phhlipa_c	OUT
spmd_p	OUT
protrna_c	OUT
ile__L_c	OUT
psd5p_c	OUT
csn_c	OUT
acolipa_p	OUT
copre2_c	OUT
glyclt_p	OUT
ribflv_c	OUT
arbtn_p	OUT
fadh2_c	OUT
kdo2lipid4p_c	OUT
phe__L_p	OUT
tyrtrna_c	OUT
cpgn_un_c	OUT
hom__L_p	OUT
ppap_c	OUT
iletrna_c	OUT
meoh_e	OUT
sertrna_sec_c	OUT
alltn_c	OUT
spmd_c	OUT
spmd_e	OUT
feoxam_e	OUT
mocogdp_c	OUT
moadcosh_c	OUT
1hdec9eg3p_p	OUT
4mop_c	OUT
arbtn_c	OUT
pydx5p_c	OUT
fmn_c	OUT
14dhncoa_c	OUT
leu__L_c	OUT
urea_p	OUT
apg160_c	OUT
glytrna_c	OUT
feoxam_un_e	OUT
na15dap_c	OUT
sucbz_c	OUT
msa_c	OUT
gicolipa_c	OUT
4mpetz_c	OUT
5mtr_c	OUT
r15bp_c	OUT
glyald_c	IS
tma_p	IS
salcn_p	IS
guln__L_e	IS
adocbl_p	IS
salchs4fe_c	IS
cbl1_e	IS
peamn_p	IS
pacald_e	IS
tmao_p	IS
gfgaragund_c	IS
fe3hox_e	IS
mththf_c	IS
salchs4fe_e	IS
mmet_c	IS
pydx_p	IS
galctn__L_p	IS
novbcn_e	IS
3hcinnm_p	IS
rnam_e	IS
but_p	IS
colipa_e	IS
thm_e	IS
gbbtn_c	IS
tma_e	IS
butso3_p	IS
fcl__L_c	IS
thm_c	IS
cechddd_c	IS
3dhguln_c	IS
pac_p	IS
glyb_p	IS
gbbtn_p	IS
icit_p	IS
2pglyc_c	IS
hqn_c	IS
mal__D_c	IS
fald_p	IS
cellb_e	IS
2pg_p	IS
cysi__L_e	IS
inost_e	IS
cbi_e	IS
pppn_e	IS
salchs4_e	IS
pppn_p	IS
tym_p	IS
pppn_c	IS
fusa_e	IS
cm_p	IS
btn_e	IS
idon__L_e	IS
thm_p	IS
airs_e	IS
micit_c	IS
23doguln_c	IS
gdp_e	IS
sbt__D_e	IS
cpgn_c	IS
urcan_c	IS
ppa_e	IS
crn__D_e	IS
galctn__D_p	IS
2pg_e	IS
pydxn_p	IS
dhptd_c	IS
crn__D_p	IS
mso3_c	IS
mincyc_p	IS
malt6p_c	IS
inost_c	IS
drib_p	IS
dhptdn_c	IS
dms_p	IS
3hadpcoa_c	IS
pacald_p	IS
bbtcoa_c	IS
gdp_p	IS
23dappa_p	IS
adocbl_e	IS
tcb_e	IS
but_e	IS
fuc__L_c	IS
mi1p__D_c	IS
ttrcyc_e	IS
crncoa_c	IS
12ppd__R_p	IS
dmso_p	IS
cyan_c	IS
icolipa_c	IS
acac_c	IS
peng_p	IS
hmgth_c	IS
oxam_c	IS
agdpcbi_c	IS
cyan_e	IS
dmso_c	IS
cysi__L_p	IS
fuc__L_p	IS
pacald_c	IS
pydam_p	IS
eca4colipa_p	IS
cynt_p	IS
fusa_p	IS
3hcinnm_c	IS
lald__D_c	IS
arab__L_p	IS
glyald_p	IS
galctn__L_e	IS
eca4colipa_e	IS
betald_c	IS
tag__D_e	IS
doxrbcn_e	IS
met__D_c	IS
cbi_c	IS
tcynt_p	IS
all__D_e	IS
crn_p	IS
trnaasn_c	IS
mmet_e	IS
novbcn_p	IS
ggagicolipa_c	IS
cellb_p	IS
pydx_e	IS
salchs4fe_p	IS
dopa_p	IS
3pg_e	IS
minohp_p	IS
6apa_e	IS
tmao_c	IS
tym_e	IS
gtp_e	IS
2dh3dgal_c	IS
dmso_e	IS
4ahmmp_c	IS
op4en_c	IS
enlipidA_p	IS
ctbtcoa_c	IS
4hoxpacd_p	IS
dhpppn_c	IS
salchsx_e	IS
o16a4colipa_e	IS
acon_C_e	IS
2ommb_c	IS
dms_c	IS
salchs2_e	IS
airs_c	IS
glutar_c	IS
6apa_p	IS
mdhdhf_c	IS
butso3_e	IS
peamn_e	IS
ctbt_p	IS
inost_p	IS
34dhpac_e	IS
glyb_e	IS
hmfurn_c	IS
adocbi_c	IS
icit_e	IS
salchs2fe_c	IS
dms_e	IS
cbl1_p	IS
cpgn_p	IS
all__D_p	IS
thptdn_c	IS
crn_e	IS
fald_c	IS
galctn__L_c	IS
2dh3dgal6p_c	IS
4mhetz_c	IS
glutcoa_c	IS
crn__D_c	IS
enlipidA_LptA_p	IS
3hpppn_c	IS
5dglcn_e	IS
fuc__L_e	IS
tcynt_e	IS
salchsx_p	IS
tcynt_c	IS
mincyc_e	IS
cysi__L_c	IS
chol_p	IS
fe3hox_p	IS
2dmmq8_c	IS
2ameph_p	IS
3hpppn_p	IS
ttrcyc_p	IS
arab__D_c	IS
glyald_e	IS
dhcinnm_c	IS
idon__L_p	IS
cynt_e	IS
sbt__D_p	IS
chol_e	IS
pydam_e	IS
fe3hox_un_p	IS
lipoate_p	IS
xyl__D_p	IS
csn_e	IS
enlipidA_e	IS
lipoate_c	IS
pprdn_c	IS
tmao_e	IS
acac_p	IS
arab__L_c	IS
4h2opntn_c	IS
23dappa_c	IS
cm_e	IS
etha_e	IS
fald_e	IS
acon_C_p	IS
fe3hox_un_c	IS
salcn_e	IS
2ombz_c	IS
alltn_p	IS
fe3hox_un_e	IS
ppal_c	IS
met__D_p	IS
peng_e	IS
ppal_p	IS
arab__D_p	IS
frmd_p	IS
mal__D_p	IS
salchs2fe_p	IS
ragund_c	IS
adocbip_c	IS
alltn_e	IS
12ppd__R_c	IS
xyl__D_e	IS
xyl__D_c	IS
pac_e	IS
met__D_e	IS
salchs2fe_e	IS
csn_p	IS
guln__L_p	IS
5aptn_c	IS
cbi_p	IS
glyb_c	IS
btn_p	IS
all__D_c	IS
mso3_p	IS
minohp_e	IS
2ameph_e	IS
frmd_e	IS
lipoate_e	IS
ppal_e	IS
4izp_c	IS
tcb_p	IS
pydxn_e	IS
cyan_p	IS
btal_c	IS
btnso_c	IS
arab__D_e	IS
galctn__D_c	IS
12ppd__R_e	IS
gtp_p	IS
dopa_e	IS
mal__D_e	IS
idon__L_c	IS
crn_c	IS
34dhpac_p	IS
fe3hox_c	IS
3pg_p	IS
o16a4colipa_p	IS
3hpppn_e	IS
2mcacn_c	IS
tag__D_p	IS
cenchddd_c	IS
mso3_e	IS
crnDcoa_c	IS
rfamp_p	IS
4hoxpacd_e	IS
5dglcn_p	IS
etha_p	IS
tma_c	IS
mmet_p	IS
3hcinnm_e	IS
5dglcn_c	IS
rfamp_e	IS
acac_e	IS
23dhacoa_c	IS
ppa_p	IS
rbl__D_c	IS
drib_e	IS
cynt_c	IS
doxrbcn_p	IS
chol_c	IS
but_c	IS
arab__L_e	IS
galctn__D_e	IS
23dappa_e	IS
hacolipa_e	IS
butso3_c	IS
gbbtn_e	IS
ctbt_c	IS
airs_p	IS
