gsn_c	GSC
ru5p__L_c	GSC
pgp161_c	GSC
3opalmACP_c	GSC
seramp_c	GSC
pro__L_c	GSC
cgly_e	GSC
pgp140_p	GSC
pmcoa_c	GSC
fru_c	GSC
kdo2lipid4L_c	GSC
mal__L_c	GSC
gmp_c	GSC
pe181_c	GSC
iasp_c	GSC
frmd_c	GSC
suchms_c	GSC
succ_p	GSC
3odecACP_c	GSC
adn_c	GSC
1pyr5c_c	GSC
3ohcoa_c	GSC
cbasp_c	GSC
cbp_c	GSC
2agpe181_c	GSC
3hocoa_c	GSC
anhgm_p	GSC
pa180_c	GSC
pa181_c	GSC
2dr1p_c	GSC
3ocddec5eACP_c	GSC
1agpg120_p	GSC
f6p_c	GSC
imacp_c	GSC
ocdca_p	GSC
aspsa_c	GSC
pa141_p	GSC
cdpdodec11eg_c	GSC
6pgc_c	GSC
hom__L_c	GSC
all6p_c	GSC
2tdecg3p_c	GSC
db4p_c	GSC
etoh_c	GSC
4per_c	GSC
glu__L_c	GSC
ocdcaACP_c	GSC
anhgm_c	GSC
ac_p	GSC
argsuc_c	GSC
dgtp_c	GSC
4c2me_c	GSC
hdcoa_c	GSC
sl26da_c	GSC
pa140_p	GSC
ahdt_c	GSC
g3p_c	GSC
dad_5_c	GSC
dtdp_c	GSC
hcys__L_c	GSC
6hmhptpp_c	GSC
dpcoa_c	GSC
ara5p_c	GSC
anhgm3p_c	GSC
asn__L_e	GSC
tdecoa_c	GSC
ppbng_c	GSC
utp_c	GSC
fdp_c	GSC
imp_c	GSC
cpppg3_c	GSC
pg120_p	GSC
phom_c	GSC
1tdec7eg3p_c	GSC
hdcea_c	GSC
gln__L_c	GSC
akg_p	GSC
23dhbzs_c	GSC
g1p_c	GSC
2agpg181_p	GSC
dnad_c	GSC
copre4_c	GSC
3pg_c	GSC
1agpg181_p	GSC
ura_e	GSC
1agpg180_p	GSC
ggbutal_c	GSC
btcoa_c	GSC
3hcddec5eACP_c	GSC
pe181_p	GSC
odecoa_c	GSC
stcoa_c	GSC
lgt__S_c	GSC
3oocoa_c	GSC
2agpe120_p	GSC
3hdcoa_c	GSC
u23ga_c	GSC
2agpg141_p	GSC
hdeACP_c	GSC
fmnh2_c	GSC
gal1p_c	GSC
13dpg_c	GSC
tyr__L_c	GSC
anhgm4p_p	GSC
1agpg141_p	GSC
anhm4p_c	GSC
acmanap_c	GSC
6hmhpt_c	GSC
g3pg_p	GSC
2dh3dgal6p_c	GSC
hexACP_c	GSC
rhcys_c	GSC
dcamp_c	GSC
quln_c	GSC
acgam1p_c	GSC
ttdcea_c	GSC
3hmrsACP_c	GSC
xmp_c	GSC
glyald_e	GSC
uLa4n_c	GSC
4adcho_c	GSC
ppgpp_c	GSC
5mdru1p_c	GSC
2cpr5p_c	GSC
g3pe_p	GSC
asn__L_p	GSC
fum_p	GSC
unagamuf_p	GSC
3hhexACP_c	GSC
ura_c	GSC
dha_e	GSC
tre6p_c	GSC
ade_c	GSC
dann_c	GSC
dxyl5p_c	GSC
pe141_c	GSC
adprib_c	GSC
cdpdtdecg_c	GSC
34hpp_c	GSC
sucglu_c	GSC
kdolipid4_c	GSC
toctd2eACP_c	GSC
acmalt_c	GSC
5aop_c	GSC
thym_c	GSC
icit_c	GSC
amet_c	GSC
12dgr141_c	GSC
gthrd_e	GSC
frdp_c	GSC
udcpdp_p	GSC
12dgr161_c	GSC
csn_c	GSC
dutp_c	GSC
ncam_c	GSC
2agpg160_c	GSC
ribflv_c	GSC
amob_c	GSC
LalaDgluMdapDala_c	GSC
pg140_p	GSC
dca_c	GSC
pgp120_c	GSC
nac_c	GSC
alltn_c	GSC
pe120_p	GSC
ru5p__D_c	GSC
1hdec9eg3p_p	GSC
pgp181_c	GSC
1odecg3p_c	GSC
gthrd_p	GSC
t3c7mrseACP_c	GSC
etha_p	GSC
lipidA_c	GSC
anth_c	GSC
t3c11vaceACP_c	GSC
clpn180_p	GSC
dhpmp_c	GSC
val__L_p	GSC
lac__L_p	GSC
rml1p_c	GSC
acglu_c	GSC
glyc_p	GSC
pg160_c	GSC
4mpetz_c	GSC
LalaLglu_c	GSC
copre2_c	GSC
2ddg6p_c	GSC
pg161_p	GSC
glyald_c	GSC
acgam6p_c	GSC
udpgal_c	GSC
clpn120_p	GSC
b2coa_c	GSC
phthr_c	GSC
pant__R_c	GSC
orot_c	GSC
rib__D_c	GSC
histd_c	GSC
tdeACP_c	GSC
dscl_c	GSC
pyr_p	GSC
pgp140_c	GSC
etha_c	GSC
ade_e	GSC
cyst__L_c	GSC
aicar_c	GSC
2agpe140_c	GSC
2mahmp_c	GSC
pgp161_p	GSC
malcoa_c	GSC
pgp120_p	GSC
acon_T_c	GSC
2agpg180_c	GSC
pe161_p	GSC
r5p_c	GSC
gua_e	GSC
his__L_p	GSC
pan4p_c	GSC
ps180_c	GSC
udpgalur_c	GSC
glu5sa_c	GSC
5mta_c	GSC
dcacoa_c	GSC
hdd2coa_c	GSC
dmpp_c	GSC
3otdcoa_c	GSC
oc2coa_c	GSC
clpn141_p	GSC
nad_c	GSC
ins_c	GSC
pa120_c	GSC
pa141_c	GSC
oaa_c	GSC
2odec11eg3p_c	GSC
eig3p_c	GSC
cdpdhdec9eg_c	GSC
arg__L_c	GSC
2dr5p_c	GSC
ps120_c	GSC
dkmpp_c	GSC
1agpe180_p	GSC
3hbcoa_c	GSC
alaala_p	GSC
1odec11eg3p_c	GSC
1tdecg3p_p	GSC
g3pg_c	GSC
LalaDgluMdap_c	GSC
3odcoa_c	GSC
thex2eACP_c	GSC
25drapp_c	GSC
prfp_c	GSC
gly_c	GSC
prbamp_c	GSC
glycogen_c	GSC
orn_p	GSC
murein4p4p_p	GSC
5apru_c	GSC
alltt_c	GSC
orot5p_c	GSC
malthp_c	GSC
tdec2eACP_c	GSC
2hdecg3p_p	GSC
myrsACP_c	GSC
skm5p_c	GSC
2agpg160_p	GSC
ohpb_c	GSC
sucsal_c	GSC
2agpe120_c	GSC
3htdcoa_c	GSC
3psme_c	GSC
clpn140_p	GSC
pe141_p	GSC
pgp181_p	GSC
12dgr120_p	GSC
pro__L_p	GSC
1tdec7eg3p_p	GSC
5mdr1p_c	GSC
anhgm3p_p	GSC
pe140_c	GSC
dhmtp_c	GSC
unaga_c	GSC
lipa_c	GSC
gdptp_c	GSC
gal_c	GSC
acald_e	GSC
asn__L_c	GSC
hxcoa_c	GSC
fum_c	GSC
ptrc_p	GSC
nmn_c	GSC
h2mb4p_c	GSC
12dgr140_c	GSC
2kmb_c	GSC
toct2eACP_c	GSC
ala_B_c	GSC
23dhba_c	GSC
cdpdodecg_c	GSC
5aizc_c	GSC
acald_p	GSC
t3c5ddeceACP_c	GSC
1tdecg3p_c	GSC
eca3und_p	GSC
dudp_c	GSC
3haACP_c	GSC
2agpg181_c	GSC
gtp_c	GSC
3ohexACP_c	GSC
cys__L_c	GSC
ocdca_c	GSC
uacmamu_c	GSC
2agpe180_c	GSC
2me4p_c	GSC
murein4px4px4p_p	GSC
8aonn_c	GSC
alaala_e	GSC
succ_c	GSC
ump_c	GSC
ahcys_c	GSC
pep_c	GSC
1hdec9eg3p_c	GSC
thr__L_c	GSC
udpg_c	GSC
cdpdhdecg_c	GSC
mnl1p_c	GSC
25aics_c	GSC
acgam_c	GSC
acglc__D_c	GSC
acACP_c	GSC
pg181_p	GSC
udpLa4o_c	GSC
cdpdtdec7eg_c	GSC
ocdcea_c	GSC
cmp_c	GSC
hethmpp_c	GSC
pe160_c	GSC
dcdp_c	GSC
hx2coa_c	GSC
12dgr120_c	GSC
dad_2_c	GSC
murein4px4p4p_p	GSC
LalaDgluMdap_e	GSC
5caiz_c	GSC
1agpe160_p	GSC
ser__D_c	GSC
2obut_c	GSC
his__L_e	GSC
ttdca_c	GSC
pa180_p	GSC
cgly_c	GSC
maltttr_c	GSC
ugmd_c	GSC
gam1p_c	GSC
malt_c	GSC
3oddecACP_c	GSC
glu5p_c	GSC
10fthf_c	GSC
um4p_c	GSC
23ddhb_c	GSC
pram_c	GSC
pmtcoa_c	GSC
4ppcys_c	GSC
3omrsACP_c	GSC
3ooctdACP_c	GSC
glc__D_c	GSC
cytd_c	GSC
dump_c	GSC
unagamuf_c	GSC
g6p_c	GSC
arg__L_e	GSC
gthox_c	GSC
3ocmrs7eACP_c	GSC
3ocvac11eACP_c	GSC
dtdpglu_c	GSC
lac__D_e	GSC
dtdp4d6dg_c	GSC
dtbt_c	GSC
pg160_p	GSC
g3pg_e	GSC
2agpe160_c	GSC
val__L_e	GSC
fpram_c	GSC
glu__D_c	GSC
2agpg120_c	GSC
forglu_c	GSC
23dhmb_c	GSC
1agpg161_p	GSC
hdcea_p	GSC
pg161_c	GSC
ametam_c	GSC
3ohdcoa_c	GSC
xu5p__D_c	GSC
fprica_c	GSC
ac_e	GSC
eca2und_p	GSC
dhnpt_c	GSC
lac__L_e	GSC
2dda7p_c	GSC
12dgr180_p	GSC
lac__D_p	GSC
2agpg140_p	GSC
3ohodcoa_c	GSC
alac__S_c	GSC
etoh_e	GSC
3php_c	GSC
3ooctACP_c	GSC
dcmp_c	GSC
pe140_p	GSC
dhap_c	GSC
butACP_c	GSC
lipa_p	GSC
2mecdp_c	GSC
pa160_c	GSC
oxadpcoa_c	GSC
adpglc_c	GSC
murein5p5p5p_p	GSC
2odec11eg3p_p	GSC
asp__L_p	GSC
murein4px4p_p	GSC
thmmp_c	GSC
glucys_c	GSC
dctp_c	GSC
4abut_c	GSC
gdp_c	GSC
acser_c	GSC
1odec11eg3p_p	GSC
met__L_c	GSC
akg_c	GSC
1odecg3p_p	GSC
12dgr181_p	GSC
thmpp_c	GSC
ser__L_e	GSC
pg180_p	GSC
glyc_c	GSC
hdca_c	GSC
gam6p_c	GSC
pg141_c	GSC
g3pe_c	GSC
lipidX_c	GSC
uacmam_c	GSC
pa120_p	GSC
murein5px4p_p	GSC
pg141_p	GSC
3hodcoa_c	GSC
prbatp_c	GSC
uLa4fn_c	GSC
dttp_c	GSC
1agpe141_p	GSC
ttdcea_p	GSC
ipdp_c	GSC
glyc3p_e	GSC
pgp141_p	GSC
glyc3p_c	GSC
1agpe181_p	GSC
ps161_c	GSC
arg__L_p	GSC
mthgxl_c	GSC
6pgl_c	GSC
clpn161_p	GSC
urdglyc_c	GSC
glu__L_p	GSC
dgmp_c	GSC
tpalm2eACP_c	GSC
2tdec7eg3p_c	GSC
xan_c	GSC
hisp_c	GSC
udcpdp_c	GSC
gua_p	GSC
glu__L_e	GSC
glyald_p	GSC
2amsa_c	GSC
4abutn_c	GSC
2agpg180_p	GSC
etoh_p	GSC
ps160_c	GSC
sbt6p_c	GSC
maltpt_c	GSC
kdo2lipid4_c	GSC
kdo_c	GSC
tyr__L_e	GSC
agm_e	GSC
for_c	GSC
murein5p4p_p	GSC
methf_c	GSC
uamag_c	GSC
cys__L_p	GSC
1agpe161_p	GSC
ac_c	GSC
2hdec9eg3p_p	GSC
uaccg_c	GSC
dtdp4aaddg_c	GSC
12dgr160_c	GSC
his__L_c	GSC
gthrd_c	GSC
e4p_c	GSC
udpLa4n_c	GSC
thr__L_p	GSC
acg5sa_c	GSC
dmlz_c	GSC
gg4abut_c	GSC
nicrnt_c	GSC
thdp_c	GSC
pa181_p	GSC
2agpe141_p	GSC
dd2coa_c	GSC
but2eACP_c	GSC
1agpe120_p	GSC
ala__D_e	GSC
1agpg160_p	GSC
asp__L_e	GSC
malACP_c	GSC
hmbil_c	GSC
ptrc_e	GSC
ps141_c	GSC
cddec5eACP_c	GSC
2hdecg3p_c	GSC
ddcacoa_c	GSC
bglycogen_c	GSC
val__L_c	GSC
acg5p_c	GSC
pppg9_c	GSC
tddec2eACP_c	GSC
dtmp_c	GSC
xtsn_c	GSC
ade_p	GSC
lipidAds_c	GSC
dha_p	GSC
glx_c	GSC
prlp_c	GSC
din_c	GSC
allul6p_c	GSC
sl2a6o_c	GSC
2agpg161_p	GSC
26dap_LL_c	GSC
1hdecg3p_p	GSC
tagdp__D_c	GSC
coa_c	GSC
acald_c	GSC
od2coa_c	GSC
2agpg161_c	GSC
3dhsk_c	GSC
2odecg3p_p	GSC
malttr_c	GSC
pgp160_c	GSC
dha_c	GSC
sucgsa_c	GSC
cdp_c	GSC
pyr_c	GSC
lac__L_c	GSC
acorn_c	GSC
2hdec9eg3p_c	GSC
hdca_p	GSC
uamr_c	GSC
ps181_c	GSC
octa_c	GSC
4izp_c	GSC
hkmpp_c	GSC
u3aga_c	GSC
udpglcur_c	GSC
ddca_c	GSC
orn_c	GSC
2agpe141_c	GSC
sucarg_c	GSC
1hdecg3p_c	GSC
fmn_c	GSC
pe180_p	GSC
ala__D_c	GSC
2agpe161_p	GSC
ttdca_p	GSC
tmrs2eACP_c	GSC
12dgr181_c	GSC
pnto__R_c	GSC
prpp_c	GSC
for_p	GSC
3dhq_c	GSC
anhgm_e	GSC
r15bp_c	GSC
2pg_c	GSC
pa161_p	GSC
clpn181_p	GSC
mlthf_c	GSC
uri_c	GSC
pg181_c	GSC
cdpdddecg_c	GSC
ala__L_c	GSC
fgam_c	GSC
23dhb_c	GSC
pgp141_c	GSC
2agpe160_p	GSC
fc1p_c	GSC
occoa_c	GSC
4met2obut_c	GSC
murein5px4px4p_p	GSC
ura_p	GSC
amp_c	GSC
glyc_e	GSC
pg180_c	GSC
tre_c	GSC
s7p_c	GSC
udpLa4fn_c	GSC
12dgr141_p	GSC
u3hga_c	GSC
LalaDglu_c	GSC
5aprbu_c	GSC
2ddecg3p_c	GSC
sucorn_c	GSC
unagamu_c	GSC
orn_e	GSC
pe161_c	GSC
copre5_c	GSC
26dap__M_c	GSC
4pasp_c	GSC
2tdec7eg3p_p	GSC
cit_c	GSC
urcan_c	GSC
3hddecACP_c	GSC
2agpg141_c	GSC
LalaDgluMdap_p	GSC
agm_c	GSC
3hhdcoa_c	GSC
chor_c	GSC
pa160_p	GSC
2agpe140_p	GSC
2agpe180_p	GSC
pro__L_e	GSC
2p4c2me_c	GSC
pap_c	GSC
cdec3eACP_c	GSC
udp_c	GSC
pgp180_p	GSC
3hddcoa_c	GSC
alaala_c	GSC
12dgr140_p	GSC
aacoa_c	GSC
lac__D_c	GSC
3hdecACP_c	GSC
ser__L_c	GSC
ptrc_c	GSC
4ampm_c	GSC
accoa_c	GSC
1ddecg3p_p	GSC
ocdcea_p	GSC
pran_c	GSC
3hoctACP_c	GSC
1agpg140_p	GSC
rbflvrd_c	GSC
ssaltpp_c	GSC
octeACP_c	GSC
ser__L_p	GSC
malthx_c	GSC
g3pe_e	GSC
urate_c	GSC
dhor__S_c	GSC
udcpp_c	GSC
dhf_c	GSC
dcyt_c	GSC
pg120_c	GSC
athr__L_c	GSC
copre3_c	GSC
2aobut_c	GSC
enter_c	GSC
dtdp4addg_c	GSC
4ppan_c	GSC
man1p_c	GSC
r1p_c	GSC
glutrna_c	GSC
3ocpalm9eACP_c	GSC
3hoctaACP_c	GSC
2agpg120_p	GSC
gua_c	GSC
citr__L_c	GSC
ctp_c	GSC
2ddecg3p_p	GSC
t3c9palmeACP_c	GSC
pe160_p	GSC
1agpe140_p	GSC
man6p_c	GSC
uppg3_c	GSC
gar_c	GSC
skm_c	GSC
uacgam_c	GSC
acon_C_c	GSC
12dgr160_p	GSC
4r5au_c	GSC
1ddecg3p_c	GSC
anhm3p_c	GSC
glyc3p_p	GSC
3mob_c	GSC
palmACP_c	GSC
pg140_c	GSC
ocACP_c	GSC
pgp160_p	GSC
anhgm4p_c	GSC
actp_c	GSC
hxa_c	GSC
2odecg3p_c	GSC
uaagmda_c	GSC
3ig3p_c	GSC
23dhdp_c	GSC
2agpg140_c	GSC
12dgr180_c	GSC
4abz_c	GSC
3hcvac11eACP_c	GSC
glu1sa_c	GSC
dc2coa_c	GSC
pe180_c	GSC
ala__D_p	GSC
2dhp_c	GSC
3hcmrs7eACP_c	GSC
air_c	GSC
thymd_c	GSC
etha_e	GSC
tyr__L_p	GSC
cys__L_e	GSC
2agpe161_c	GSC
dhpt_c	GSC
murein5p5p_p	GSC
ggptrc_c	GSC
uama_c	GSC
2agpe181_p	GSC
pa140_c	GSC
pser__L_c	GSC
LalaDgluMdapDala_p	GSC
ckdo_c	GSC
ichor_c	GSC
udcpp_p	GSC
clpn160_p	GSC
pa161_c	GSC
dcaACP_c	GSC
pgp180_c	GSC
dmbzid_c	GSC
3hpalmACP_c	GSC
duri_c	GSC
lald__L_c	GSC
ddca_p	GSC
thf_c	GSC
pyr_e	GSC
ps140_c	GSC
td2coa_c	GSC
dhmptp_c	GSC
3oddcoa_c	GSC
12dgr161_p	GSC
tdcoa_c	GSC
pphn_c	GSC
hxan_c	GSC
3hcpalm9eACP_c	GSC
pe120_c	GSC
asp__L_c	GSC
succoa_c	GSC
uagmda_c	GSC
dgdp_c	GSC
LalaDgluMdapDala_e	GSC
3hhcoa_c	GSC
kdo8p_c	GSC
dgsn_c	GSC
uLa4n_p	GSC
2tdecg3p_p	GSC
ugmda_c	GSC
grdp_c	GSC
cgly_p	GSC
ddcaACP_c	GSC
5mtr_c	GSC
actACP_c	GSC
agm_p	GSC
rmn_c	IN
Sfglutth_c	IN
cys__D_c	IN
peamn_p	IN
gsn_e	IN
hxa_e	IN
3oxoadp_c	IN
mal__L_e	IN
aps_c	IN
galur_c	IN
duri_e	IN
3hcinnm_p	IN
ccmuac_c	IN
3amp_e	IN
gal1p_e	IN
cellb_e	IN
progly_e	IN
imp_e	IN
g3ps_c	IN
atp_c	IN
sbt__D_e	IN
skm_e	IN
cit_e	IN
inost_c	IN
gp4g_c	IN
23cgmp_p	IN
acmana_e	IN
pser__L_p	IN
abt__D_c	IN
2ddglcn_p	IN
glcur_c	IN
glyc__R_c	IN
met__L_p	IN
g6p_e	IN
rmn_p	IN
cyan_c	IN
gal1p_p	IN
2ddglcn_e	IN
maltpt_p	IN
fru_e	IN
arbt6p_c	IN
arab__L_p	IN
xylu__L_c	IN
dcmp_p	IN
skm_p	IN
34dhpha_c	IN
bz_e	IN
cmp_p	IN
hxa_p	IN
malt_p	IN
ala_B_p	IN
2dh3dgal_c	IN
op4en_c	IN
3dhgulnp_c	IN
cmp_e	IN
murein4p3p_p	IN
ethso3_p	IN
thrp_p	IN
mucl_c	IN
sucr_p	IN
4abut_p	IN
adn_p	IN
dcmp_e	IN
ascb6p_c	IN
pnto__R_e	IN
fuc__L_e	IN
ap5a_c	IN
suc6p_c	IN
melib_p	IN
sbt__D_p	IN
dhcinnm_c	IN
4h2opntn_c	IN
arab__L_c	IN
3ump_p	IN
gam6p_p	IN
gam6p_e	IN
23cgmp_e	IN
fru_p	IN
rmn_e	IN
phaccoa_c	IN
glcn_p	IN
xyl__D_e	IN
imp_p	IN
dadp_c	IN
dimp_p	IN
3ump_e	IN
glcr_p	IN
tartr__L_c	IN
g3pi_e	IN
2dhphaccoa_c	IN
g3ps_e	IN
mnl_e	IN
progly_p	IN
dgmp_p	IN
galctn__D_c	IN
mal__D_e	IN
glyc2p_e	IN
gal_bD_p	IN
progly_c	IN
cytd_p	IN
3cmp_p	IN
orot_p	IN
mmet_p	IN
2ohed_c	IN
paps_c	IN
abt__D_e	IN
23ccmp_p	IN
gmp_e	IN
nmn_p	IN
ump_p	IN
ala__L_p	IN
r5p_p	IN
murein3px4p_p	IN
colipa_c	IN
ocdcea_e	IN
mmet_c	IN
lcts_p	IN
lcts_c	IN
dcyt_e	IN
thm_e	IN
fcl__L_c	IN
thm_c	IN
met__L_e	IN
malt_e	IN
acgam_e	IN
din_e	IN
dad_2_e	IN
sulfac_e	IN
2ddglcn_c	IN
amp_e	IN
man_p	IN
damp_p	IN
d5kgp_c	IN
sarcs_c	IN
3sala_c	IN
thr__L_e	IN
23dappa_p	IN
dgmp_e	IN
galur_p	IN
2h3oppan_c	IN
24dhhed_c	IN
taur_e	IN
udpgal_p	IN
rml_c	IN
fuc__L_p	IN
galt_e	IN
udpg_e	IN
cellb_c	IN
tyrp_p	IN
xylu__D_c	IN
bz12diol_c	IN
glyc2p_p	IN
murein3p3p_p	IN
dump_p	IN
dgsn_e	IN
gly_e	IN
fecrm_c	IN
ser__D_p	IN
hdca_e	IN
tre_p	IN
malthx_p	IN
tartr__L_e	IN
inost_p	IN
man6p_e	IN
23camp_e	IN
glyc__R_e	IN
colipa_p	IN
rbt_e	IN
xtp_c	IN
malttr_e	IN
nac_p	IN
glc__D_e	IN
altrn_c	IN
dca_p	IN
uri_e	IN
dtmp_e	IN
mal__D_p	IN
ascb__L_p	IN
galct__D_c	IN
5cohe_c	IN
udpgal_e	IN
2dhglcn_c	IN
galur_e	IN
ala__L_e	IN
fruur_c	IN
14glucan_p	IN
4hphac_c	IN
g6p_p	IN
ttdcea_e	IN
man_e	IN
malttr_p	IN
sulfac_c	IN
taur_c	IN
fum_e	IN
metsox_S__L_c	IN
xan_e	IN
23dappa_e	IN
fuc__L_c	IN
ala_B_e	IN
ascb__L_e	IN
dad_2_p	IN
glc__D_p	IN
sucr_e	IN
succ_e	IN
duri_p	IN
taur_p	IN
g3pc_c	IN
feenter_e	IN
gmp_p	IN
dimp_e	IN
glyc__R_p	IN
14glucan_e	IN
mal__D_c	IN
ditp_c	IN
idp_c	IN
catechol_c	IN
glcr_e	IN
mercppyr_c	IN
galctn__D_p	IN
malthx_e	IN
pnto__R_p	IN
maltpt_e	IN
3cmp_e	IN
mi1p__D_c	IN
galct__D_p	IN
ins_p	IN
hmgth_c	IN
rib__D_p	IN
4abut_e	IN
damp_e	IN
2ins_c	IN
pacald_c	IN
gal_p	IN
metsox_R__L_c	IN
ethso3_c	IN
akg_e	IN
mmet_e	IN
glcn_e	IN
bz_c	IN
14glucan_c	IN
r5p_e	IN
rbt_c	IN
glcn_c	IN
glcur_p	IN
tre_e	IN
dcyt_p	IN
g3pc_e	IN
fecrm_p	IN
tartr__L_p	IN
mnl_p	IN
dump_e	IN
itp_c	IN
for_e	IN
ocdca_e	IN
octa_p	IN
ser__D_e	IN
ap4a_c	IN
nmn_e	IN
5dh4dglc_c	IN
feenter_c	IN
xyl__D_p	IN
gdpmann_c	IN
gln__L_p	IN
melib_c	IN
d5kg_c	IN
din_p	IN
dtmp_p	IN
gly_p	IN
ins_e	IN
5odhf2a_c	IN
xu5p__L_c	IN
glcur_e	IN
galt_p	IN
g1p_e	IN
mana_c	IN
hkntd_c	IN
hpyr_c	IN
pser__L_e	IN
octa_e	IN
ump_e	IN
xan_p	IN
gln__L_e	IN
adn_e	IN
amp_p	IN
glcr_c	IN
tagur_c	IN
2hh24dd_c	IN
adp_c	IN
gam_p	IN
3gmp_p	IN
f6p_e	IN
galct__D_e	IN
gam_e	IN
pacald_e	IN
cys__D_p	IN
nac_e	IN
dkdi_c	IN
lyx__L_c	IN
sulfac_p	IN
5cmhm_c	IN
feenter_p	IN
galt1p_c	IN
man6p_p	IN
thymd_p	IN
inost_e	IN
g1p_p	IN
dca_e	IN
ethso3_e	IN
thm_p	IN
datp_c	IN
murein5p3p_p	IN
23cump_p	IN
cys__D_e	IN
3gmp_e	IN
orot_e	IN
acmana_p	IN
mal__L_p	IN
3hadpcoa_c	IN
lyx__L_e	IN
pacald_p	IN
rbl__L_c	IN
melib_e	IN
dimp_c	IN
3amp_p	IN
tag6p__D_c	IN
g3pi_p	IN
lyx__L_p	IN
cytd_e	IN
damp_c	IN
f1p_c	IN
tyrp_e	IN
3hcinnm_c	IN
f6p_p	IN
g3pc_p	IN
camp_c	IN
pac_c	IN
4ahmmp_c	IN
dhpppn_c	IN
maltttr_p	IN
peamn_e	IN
uri_p	IN
thymd_e	IN
acgam_p	IN
gal_bD_e	IN
gal_e	IN
23cump_e	IN
fecrm_e	IN
5cmhmsa_c	IN
4mhetz_c	IN
3hpppn_c	IN
dxyl_c	IN
thrp_e	IN
3hpppn_p	IN
csn_e	IN
g3pi_c	IN
dgsn_p	IN
23dappa_c	IN
maltttr_e	IN
xyl__D_c	IN
hdcea_e	IN
23camp_p	IN
lcts_e	IN
csn_p	IN
gsn_p	IN
ttdca_e	IN
23ccmp_e	IN
ddca_e	IN
rib__D_e	IN
3hpppn_e	IN
hkndd_c	IN
3hcinnm_e	IN
udpg_p	IN
4hphac_e	IN
rbl__D_c	IN
g3ps_p	IN
arab__L_e	IN
but_c	IN
msa_c	IN
galctn__D_e	IN
indole_c	OUT
hhlipa_c	OUT
phpyr_c	OUT
glyclt_c	OUT
mql8_c	OUT
hom__L_e	OUT
urea_c	OUT
gtspmd_c	OUT
gmhep17bp_c	OUT
argtrna_c	OUT
indole_e	OUT
rdmbzi_c	OUT
glntrna_c	OUT
sheme_c	OUT
valtrna_c	OUT
cpg160_c	OUT
apg140_c	OUT
phetrna_c	OUT
pdx5p_c	OUT
asntrna_c	OUT
lipa_cold_p	OUT
2omhmbl_c	OUT
kdo2lipid4_e	OUT
apg141_c	OUT
thrtrna_c	OUT
fecrm_un_c	OUT
scl_c	OUT
15dap_e	OUT
gthox_e	OUT
dhptd_c	OUT
fmettrna_c	OUT
apg161_c	OUT
codhpre6_c	OUT
pheme_c	OUT
2dmmql8_c	OUT
co2dam_c	OUT
pydx_c	OUT
sectrna_c	OUT
cpe160_c	OUT
hemeO_c	OUT
gmhep1p_c	OUT
leu__L_p	OUT
apg120_c	OUT
kdo2lipid4_p	OUT
4hthr_c	OUT
2ommbl_c	OUT
5mthf_c	OUT
ile__L_p	OUT
gcald_c	OUT
asptrna_c	OUT
enlipa_p	OUT
2ombzl_c	OUT
2tpr3dpcoa_c	OUT
glyclt_e	OUT
lpp_p	OUT
adphep_DD_c	OUT
trp__L_p	OUT
gthox_p	OUT
oxptn_c	OUT
ppoh_c	OUT
phe__L_e	OUT
leutrna_c	OUT
murein5px3p_p	OUT
agdpcbi_c	OUT
N1aspmd_c	OUT
lipa_cold_e	OUT
cobya_c	OUT
thym_p	OUT
dtdp4d6dm_c	OUT
adcobdam_c	OUT
aact_c	OUT
indpyr_c	OUT
hlipa_c	OUT
dtdprmn_c	OUT
appl_c	OUT
trp__L_c	OUT
lald__D_c	OUT
alatrna_c	OUT
copre8_c	OUT
2ippm_c	OUT
gmhep7p_c	OUT
cbi_c	OUT
btn_c	OUT
histrna_c	OUT
5prdmbz_c	OUT
lys__L_p	OUT
3mop_c	OUT
trptrna_c	OUT
3c3hmp_c	OUT
indole_p	OUT
4hba_c	OUT
cpg180_c	OUT
acetol_c	OUT
pheme_p	OUT
12ppd__S_e	OUT
pyam5p_c	OUT
dhna_c	OUT
lipa_cold_c	OUT
cpe180_c	OUT
adphep_LD_c	OUT
acser_e	OUT
fad_c	OUT
acser_p	OUT
q8_c	OUT
btd_RR_c	OUT
acolipa_e	OUT
glutar_c	OUT
aconm_c	OUT
mtpp_c	OUT
ppp9_c	OUT
btd_RR_e	OUT
apg180_c	OUT
octdp_c	OUT
3c2hmp_c	OUT
2ahbut_c	OUT
phe__L_c	OUT
sbzcoa_c	OUT
adocbl_c	OUT
3hppnl_c	OUT
hphhlipa_c	OUT
2shchc_c	OUT
aacald_c	OUT
mqn8_c	OUT
adocbi_c	OUT
anhm_c	OUT
13ppd_c	OUT
diact_e	OUT
mettrna_c	OUT
15dap_p	OUT
cystrna_c	OUT
ppa_c	OUT
glutcoa_c	OUT
doxopa_c	OUT
urea_e	OUT
enter_p	OUT
2ohph_c	OUT
apg181_c	OUT
leu__L_e	OUT
cbl1_c	OUT
pheme_e	OUT
acanth_c	OUT
ile__L_e	OUT
actn__R_c	OUT
pprdn_c	OUT
diact_c	OUT
4hbz_c	OUT
q8h2_c	OUT
man_c	OUT
pydxn_c	OUT
ppcoa_c	OUT
acmum6p_c	OUT
co_c	OUT
5drib_c	OUT
co1dam_c	OUT
3ophb_c	OUT
ppal_p	OUT
pydam_c	OUT
ppal_c	OUT
eca4und_p	OUT
13ppd_e	OUT
15dap_c	OUT
adocbip_c	OUT
nadp_c	OUT
3c4mop_c	OUT
12ppd__R_c	OUT
lystrna_c	OUT
sertrna_c	OUT
2oph_c	OUT
23dhmp_c	OUT
2omph_c	OUT
copre6_c	OUT
5aptn_c	OUT
thym_e	OUT
adcobhex_c	OUT
ppal_e	OUT
protrna_c	OUT
ile__L_c	OUT
acolipa_p	OUT
glyclt_p	OUT
fadh2_c	OUT
kdo2lipid4p_c	OUT
phe__L_p	OUT
tyrtrna_c	OUT
hom__L_p	OUT
n8aspmd_c	OUT
ppap_c	OUT
lys__L_e	OUT
iletrna_c	OUT
sertrna_sec_c	OUT
spmd_c	OUT
12ppd__S_c	OUT
4mop_c	OUT
trp__L_e	OUT
pydx5p_c	OUT
leu__L_c	OUT
13ppd_p	OUT
urea_p	OUT
apg160_c	OUT
glytrna_c	OUT
lys__L_c	OUT
sucbz_c	OUT
tma_p	IS
adocbl_p	IS
acgal_e	IS
isetac_e	IS
cbl1_e	IS
tmao_p	IS
fe3hox_e	IS
xmp_p	IS
galctn__L_p	IS
colipa_e	IS
but_p	IS
tma_e	IS
uacgam_p	IS
butso3_p	IS
glyb_p	IS
2pglyc_c	IS
hqn_c	IS
fald_p	IS
metsox_S__L_e	IS
fe3dhbzs_p	IS
cbi_e	IS
pppn_e	IS
acgam1p_p	IS
idon__L_e	IS
psclys_p	IS
tym_p	IS
pppn_c	IS
pppn_p	IS
gdp_e	IS
cpgn_c	IS
ppa_e	IS
crn__D_p	IS
mso3_c	IS
malt6p_c	IS
psclys_e	IS
26dap__M_p	IS
dms_p	IS
udpglcur_p	IS
gdp_p	IS
adocbl_e	IS
fruur_p	IS
but_e	IS
feoxam_c	IS
fe3dhbzs_c	IS
dmso_p	IS
hxan_p	IS
didp_c	IS
2dhguln_c	IS
cyan_e	IS
metsox_R__L_e	IS
dmso_c	IS
cynt_p	IS
glcur1p_p	IS
25dkglcn_c	IS
halipa_e	IS
galctn__L_e	IS
betald_c	IS
acgam1p_e	IS
met__D_c	IS
tcynt_p	IS
all__D_e	IS
crn_p	IS
frulys_p	IS
fe3dhbzs_e	IS
arbtn_fe3_c	IS
dopa_p	IS
manglyc_p	IS
tmao_c	IS
xtsn_p	IS
tym_e	IS
metsox_S__L_p	IS
gtp_e	IS
isetac_p	IS
xtsn_e	IS
dmso_e	IS
acmum_p	IS
4hoxpacd_p	IS
dna5mtc_c	IS
acgal1p_e	IS
dms_c	IS
manglyc_e	IS
acgal_p	IS
butso3_e	IS
udpglcur_e	IS
feoxam_p	IS
ctbt_p	IS
34dhpac_e	IS
glyb_e	IS
hxan_e	IS
udpacgal_p	IS
dms_e	IS
cpgn_p	IS
cbl1_p	IS
all__D_p	IS
crn_e	IS
fald_c	IS
xylu__L_p	IS
galctn__L_c	IS
crn__D_c	IS
5dglcn_e	IS
tcynt_c	IS
tcynt_e	IS
dna_c	IS
chol_p	IS
fe3hox_p	IS
isetac_c	IS
2dmmq8_c	IS
cynt_e	IS
idon__L_p	IS
fruur_e	IS
acmum_e	IS
chol_e	IS
26dap__M_e	IS
xdp_c	IS
tmao_e	IS
fald_e	IS
met__D_p	IS
lipa_e	IS
xylu__L_e	IS
arbtn_fe3_p	IS
met__D_e	IS
cbi_p	IS
glyb_c	IS
mso3_p	IS
phhlipa_c	IS
spmd_p	IS
metsox_R__L_p	IS
cyan_p	IS
btal_c	IS
btnso_c	IS
xmp_e	IS
gtp_p	IS
dopa_e	IS
acgal1p_p	IS
idon__L_c	IS
crn_c	IS
34dhpac_p	IS
fe3hox_c	IS
spmd_e	IS
feoxam_e	IS
glcur1p_e	IS
udpacgal_e	IS
mso3_e	IS
4hoxpacd_e	IS
5dglcn_p	IS
tma_c	IS
Nmtrp_c	IS
5dglcn_c	IS
ppa_p	IS
cynt_c	IS
chol_c	IS
frulys_e	IS
uacgam_e	IS
hacolipa_e	IS
butso3_c	IS
ctbt_c	IS
